Id,Id2,Geography,Food Stamps Total,Margin of Error; Total:,Estimate; Household received Food Stamps/SNAP in the past 12 months:,Margin of Error; Household received Food Stamps/SNAP in the past 12 months:,Estimate; Household received Food Stamps/SNAP in the past 12 months: - Households with 1 or more persons with a disability,Margin of Error; Household received Food Stamps/SNAP in the past 12 months: - Households with 1 or more persons with a disability,Estimate; Household received Food Stamps/SNAP in the past 12 months: - Households with no persons with a disability,Margin of Error; Household received Food Stamps/SNAP in the past 12 months: - Households with no persons with a disability,Estimate; Household did not receive Food Stamps/SNAP in the past 12 months:,Margin of Error; Household did not receive Food Stamps/SNAP in the past 12 months:,Estimate; Household did not receive Food Stamps/SNAP in the past 12 months: - Households with 1 or more persons with a disability,Margin of Error; Household did not receive Food Stamps/SNAP in the past 12 months: - Households with 1 or more persons with a disability,Estimate; Household did not receive Food Stamps/SNAP in the past 12 months: - Households with no persons with a disability,Margin of Error; Household did not receive Food Stamps/SNAP in the past 12 months: - Households with no persons with a disability
1500000US530330001001,530330001001,"Block Group 1, Census Tract 1, King County, Washington",629,95,1,9,0,12,1,9,628,96,127,68,501,109
1500000US530330001002,530330001002,"Block Group 2, Census Tract 1, King County, Washington",760,139,153,93,32,52,121,81,607,129,108,72,499,129
1500000US530330001003,530330001003,"Block Group 3, Census Tract 1, King County, Washington",684,110,160,84,86,71,74,49,524,109,127,81,397,101
1500000US530330001004,530330001004,"Block Group 4, Census Tract 1, King County, Washington",928,160,299,118,178,91,121,72,629,147,39,36,590,147
1500000US530330001005,530330001005,"Block Group 5, Census Tract 1, King County, Washington",546,111,77,45,42,41,35,33,469,107,64,50,405,101
1500000US530330002001,530330002001,"Block Group 1, Census Tract 2, King County, Washington",471,93,22,35,22,35,0,12,449,94,53,49,396,97
1500000US530330002002,530330002002,"Block Group 2, Census Tract 2, King County, Washington",468,142,100,108,0,12,100,108,368,102,64,55,304,91
1500000US530330002003,530330002003,"Block Group 3, Census Tract 2, King County, Washington",835,130,71,51,53,49,18,32,764,132,62,48,702,134
1500000US530330002004,530330002004,"Block Group 4, Census Tract 2, King County, Washington",541,95,0,12,0,12,0,12,541,95,72,53,469,98
1500000US530330002005,530330002005,"Block Group 5, Census Tract 2, King County, Washington",754,131,201,118,27,33,174,113,553,117,141,74,412,117
1500000US530330002006,530330002006,"Block Group 6, Census Tract 2, King County, Washington",484,83,13,20,13,20,0,12,471,84,78,55,393,92
1500000US530330003001,530330003001,"Block Group 1, Census Tract 3, King County, Washington",519,62,55,54,6,13,49,55,464,75,68,41,396,83
1500000US530330003002,530330003002,"Block Group 2, Census Tract 3, King County, Washington",657,64,73,67,31,46,42,48,584,91,180,71,404,102
1500000US530330004011,530330004011,"Block Group 1, Census Tract 4.01, King County, Washington",1972,190,560,224,272,148,288,165,1412,221,264,111,1148,206
1500000US530330004012,530330004012,"Block Group 2, Census Tract 4.01, King County, Washington",684,149,0,12,0,12,0,12,684,149,44,40,640,157
1500000US530330004013,530330004013,"Block Group 3, Census Tract 4.01, King County, Washington",886,133,284,101,101,67,183,82,602,134,248,108,354,116
1500000US530330004021,530330004021,"Block Group 1, Census Tract 4.02, King County, Washington",554,112,14,22,0,12,14,22,540,114,169,91,371,104
1500000US530330004022,530330004022,"Block Group 2, Census Tract 4.02, King County, Washington",383,81,61,57,35,42,26,38,322,92,67,55,255,98
1500000US530330004023,530330004023,"Block Group 3, Census Tract 4.02, King County, Washington",664,139,104,75,48,45,56,64,560,155,85,88,475,141
1500000US530330004024,530330004024,"Block Group 4, Census Tract 4.02, King County, Washington",791,118,39,49,39,49,0,12,752,118,337,90,415,106
1500000US530330005001,530330005001,"Block Group 1, Census Tract 5, King County, Washington",466,54,0,12,0,12,0,12,466,54,88,37,378,68
1500000US530330005002,530330005002,"Block Group 2, Census Tract 5, King County, Washington",363,48,0,12,0,12,0,12,363,48,59,33,304,50
1500000US530330005003,530330005003,"Block Group 3, Census Tract 5, King County, Washington",422,55,0,12,0,12,0,12,422,55,40,28,382,58
1500000US530330006001,530330006001,"Block Group 1, Census Tract 6, King County, Washington",445,75,14,23,0,12,14,23,431,74,75,52,356,76
1500000US530330006002,530330006002,"Block Group 2, Census Tract 6, King County, Washington",536,114,110,90,59,73,51,54,426,91,112,58,314,89
1500000US530330006003,530330006003,"Block Group 3, Census Tract 6, King County, Washington",684,141,28,32,0,12,28,32,656,150,28,32,628,151
1500000US530330006004,530330006004,"Block Group 4, Census Tract 6, King County, Washington",769,114,86,59,30,33,56,51,683,123,30,33,653,122
1500000US530330006005,530330006005,"Block Group 5, Census Tract 6, King County, Washington",336,90,42,51,0,12,42,51,294,88,140,89,154,62
1500000US530330006006,530330006006,"Block Group 6, Census Tract 6, King County, Washington",653,127,126,76,60,49,66,56,527,123,71,74,456,117
1500000US530330007001,530330007001,"Block Group 1, Census Tract 7, King County, Washington",1008,125,199,99,50,51,149,79,809,140,114,68,695,156
1500000US530330007002,530330007002,"Block Group 2, Census Tract 7, King County, Washington",445,93,18,28,0,12,18,28,427,94,57,47,370,99
1500000US530330007003,530330007003,"Block Group 3, Census Tract 7, King County, Washington",456,88,15,26,0,12,15,26,441,93,34,39,407,93
1500000US530330007004,530330007004,"Block Group 4, Census Tract 7, King County, Washington",279,71,14,26,14,26,0,12,265,68,76,59,189,77
1500000US530330008001,530330008001,"Block Group 1, Census Tract 8, King County, Washington",499,62,14,17,6,11,8,14,485,61,66,38,419,68
1500000US530330008002,530330008002,"Block Group 2, Census Tract 8, King County, Washington",541,63,49,46,0,12,49,46,492,73,43,27,449,79
1500000US530330009001,530330009001,"Block Group 1, Census Tract 9, King County, Washington",445,48,21,19,0,12,21,19,424,46,58,38,366,49
1500000US530330009002,530330009002,"Block Group 2, Census Tract 9, King County, Washington",405,43,5,7,0,12,5,7,400,44,34,20,366,45
1500000US530330010001,530330010001,"Block Group 1, Census Tract 10, King County, Washington",331,54,95,49,42,32,53,41,236,42,27,20,209,41
1500000US530330010002,530330010002,"Block Group 2, Census Tract 10, King County, Washington",431,53,30,29,0,12,30,29,401,56,38,19,363,56
1500000US530330011001,530330011001,"Block Group 1, Census Tract 11, King County, Washington",501,85,8,12,8,12,0,12,493,84,85,52,408,93
1500000US530330011002,530330011002,"Block Group 2, Census Tract 11, King County, Washington",584,74,38,37,8,15,30,35,546,79,45,32,501,81
1500000US530330012001,530330012001,"Block Group 1, Census Tract 12, King County, Washington",488,92,14,23,14,23,0,12,474,91,74,57,400,99
1500000US530330012002,530330012002,"Block Group 2, Census Tract 12, King County, Washington",467,160,58,93,0,12,58,93,409,135,18,30,391,134
1500000US530330012003,530330012003,"Block Group 3, Census Tract 12, King County, Washington",1103,175,15,25,0,12,15,25,1088,175,237,115,851,144
1500000US530330012004,530330012004,"Block Group 4, Census Tract 12, King County, Washington",758,144,160,77,68,45,92,67,598,152,163,80,435,141
1500000US530330012005,530330012005,"Block Group 5, Census Tract 12, King County, Washington",805,187,36,41,36,41,0,12,769,187,95,55,674,186
1500000US530330013001,530330013001,"Block Group 1, Census Tract 13, King County, Washington",807,105,158,103,109,83,49,58,649,114,188,72,461,106
1500000US530330013002,530330013002,"Block Group 2, Census Tract 13, King County, Washington",640,111,127,66,65,39,62,63,513,125,65,59,448,122
1500000US530330013003,530330013003,"Block Group 3, Census Tract 13, King County, Washington",719,103,43,39,0,12,43,39,676,100,122,70,554,108
1500000US530330014001,530330014001,"Block Group 1, Census Tract 14, King County, Washington",588,113,82,106,18,27,64,101,506,109,104,59,402,110
1500000US530330014002,530330014002,"Block Group 2, Census Tract 14, King County, Washington",463,100,64,73,18,29,46,67,399,95,89,60,310,100
1500000US530330014003,530330014003,"Block Group 3, Census Tract 14, King County, Washington",603,107,14,24,0,12,14,24,589,106,88,59,501,114
1500000US530330014004,530330014004,"Block Group 4, Census Tract 14, King County, Washington",635,93,80,99,16,25,64,97,555,91,68,51,487,88
1500000US530330015001,530330015001,"Block Group 1, Census Tract 15, King County, Washington",514,66,14,16,7,11,7,10,500,66,68,42,432,65
1500000US530330015002,530330015002,"Block Group 2, Census Tract 15, King County, Washington",589,71,9,14,0,12,9,14,580,73,135,69,445,75
1500000US530330016001,530330016001,"Block Group 1, Census Tract 16, King County, Washington",612,62,0,12,0,12,0,12,612,62,83,41,529,70
1500000US530330016002,530330016002,"Block Group 2, Census Tract 16, King County, Washington",524,62,0,12,0,12,0,12,524,62,104,45,420,69
1500000US530330016003,530330016003,"Block Group 3, Census Tract 16, King County, Washington",680,101,35,43,8,12,27,41,645,96,94,41,551,96
1500000US530330017011,530330017011,"Block Group 1, Census Tract 17.01, King County, Washington",864,110,129,76,28,31,101,75,735,100,78,45,657,105
1500000US530330017012,530330017012,"Block Group 2, Census Tract 17.01, King County, Washington",510,81,44,49,38,48,6,11,466,74,50,37,416,75
1500000US530330017013,530330017013,"Block Group 3, Census Tract 17.01, King County, Washington",568,84,29,28,8,12,21,25,539,86,102,48,437,88
1500000US530330017021,530330017021,"Block Group 1, Census Tract 17.02, King County, Washington",878,104,162,81,95,64,67,58,716,111,123,68,593,112
1500000US530330017022,530330017022,"Block Group 2, Census Tract 17.02, King County, Washington",570,97,52,57,52,57,0,12,518,96,136,89,382,89
1500000US530330017023,530330017023,"Block Group 3, Census Tract 17.02, King County, Washington",414,84,38,34,12,19,26,28,376,87,68,47,308,86
1500000US530330017024,530330017024,"Block Group 4, Census Tract 17.02, King County, Washington",281,64,0,12,0,12,0,12,281,64,21,27,260,63
1500000US530330018001,530330018001,"Block Group 1, Census Tract 18, King County, Washington",673,122,81,82,7,15,74,83,592,117,60,54,532,117
1500000US530330018002,530330018002,"Block Group 2, Census Tract 18, King County, Washington",684,145,67,47,40,41,27,34,617,142,0,12,617,142
1500000US530330018003,530330018003,"Block Group 3, Census Tract 18, King County, Washington",879,162,30,37,20,31,10,20,849,167,111,88,738,161
1500000US530330019001,530330019001,"Block Group 1, Census Tract 19, King County, Washington",1232,95,80,60,33,40,47,44,1152,104,188,70,964,117
1500000US530330019002,530330019002,"Block Group 2, Census Tract 19, King County, Washington",540,67,28,26,16,18,12,18,512,73,101,50,411,73
1500000US530330019003,530330019003,"Block Group 3, Census Tract 19, King County, Washington",461,58,7,11,0,12,7,11,454,60,60,32,394,65
1500000US530330020001,530330020001,"Block Group 1, Census Tract 20, King County, Washington",826,86,48,51,29,42,19,30,778,89,126,52,652,83
1500000US530330020002,530330020002,"Block Group 2, Census Tract 20, King County, Washington",452,59,12,19,0,12,12,19,440,59,79,50,361,63
1500000US530330020003,530330020003,"Block Group 3, Census Tract 20, King County, Washington",315,53,12,15,5,10,7,11,303,53,50,31,253,45
1500000US530330021001,530330021001,"Block Group 1, Census Tract 21, King County, Washington",640,71,8,12,0,12,8,12,632,73,91,45,541,80
1500000US530330021002,530330021002,"Block Group 2, Census Tract 21, King County, Washington",415,74,59,56,8,12,51,55,356,71,76,56,280,74
1500000US530330021003,530330021003,"Block Group 3, Census Tract 21, King County, Washington",685,82,38,28,17,18,21,21,647,83,64,31,583,84
1500000US530330022001,530330022001,"Block Group 1, Census Tract 22, King County, Washington",575,75,0,12,0,12,0,12,575,75,75,50,500,83
1500000US530330022002,530330022002,"Block Group 2, Census Tract 22, King County, Washington",528,64,0,12,0,12,0,12,528,64,78,50,450,73
1500000US530330022003,530330022003,"Block Group 3, Census Tract 22, King County, Washington",570,84,0,12,0,12,0,12,570,84,47,36,523,91
1500000US530330022004,530330022004,"Block Group 4, Census Tract 22, King County, Washington",529,66,11,17,0,12,11,17,518,73,73,53,445,89
1500000US530330024001,530330024001,"Block Group 1, Census Tract 24, King County, Washington",362,56,15,23,15,23,0,12,347,59,58,32,289,64
1500000US530330024002,530330024002,"Block Group 2, Census Tract 24, King County, Washington",316,54,14,16,0,12,14,16,302,54,64,39,238,54
1500000US530330024003,530330024003,"Block Group 3, Census Tract 24, King County, Washington",579,69,6,10,6,10,0,12,573,70,54,34,519,78
1500000US530330025001,530330025001,"Block Group 1, Census Tract 25, King County, Washington",653,62,17,23,17,23,0,12,636,67,101,48,535,80
1500000US530330025002,530330025002,"Block Group 2, Census Tract 25, King County, Washington",618,68,54,33,46,28,8,14,564,70,86,50,478,83
1500000US530330026001,530330026001,"Block Group 1, Census Tract 26, King County, Washington",497,83,16,18,6,9,10,15,481,82,41,34,440,90
1500000US530330026002,530330026002,"Block Group 2, Census Tract 26, King County, Washington",512,68,9,15,0,12,9,15,503,67,52,32,451,72
1500000US530330026003,530330026003,"Block Group 3, Census Tract 26, King County, Washington",549,73,9,13,9,13,0,12,540,72,54,34,486,69
1500000US530330026004,530330026004,"Block Group 4, Census Tract 26, King County, Washington",361,61,6,9,0,12,6,9,355,62,64,36,291,61
1500000US530330027001,530330027001,"Block Group 1, Census Tract 27, King County, Washington",726,111,0,12,0,12,0,12,726,111,98,80,628,128
1500000US530330027002,530330027002,"Block Group 2, Census Tract 27, King County, Washington",600,101,17,28,17,28,0,12,583,106,75,54,508,108
1500000US530330027003,530330027003,"Block Group 3, Census Tract 27, King County, Washington",454,94,0,12,0,12,0,12,454,94,54,42,400,91
1500000US530330027004,530330027004,"Block Group 4, Census Tract 27, King County, Washington",630,84,0,12,0,12,0,12,630,84,44,34,586,90
1500000US530330028001,530330028001,"Block Group 1, Census Tract 28, King County, Washington",369,81,0,12,0,12,0,12,369,81,47,37,322,82
1500000US530330028002,530330028002,"Block Group 2, Census Tract 28, King County, Washington",490,69,0,12,0,12,0,12,490,69,33,39,457,64
1500000US530330028003,530330028003,"Block Group 3, Census Tract 28, King County, Washington",615,111,26,31,10,18,16,25,589,107,10,17,579,110
1500000US530330028004,530330028004,"Block Group 4, Census Tract 28, King County, Washington",645,93,0,12,0,12,0,12,645,93,82,64,563,100
1500000US530330029001,530330029001,"Block Group 1, Census Tract 29, King County, Washington",676,84,19,15,7,12,12,17,657,86,52,34,605,93
1500000US530330029002,530330029002,"Block Group 2, Census Tract 29, King County, Washington",656,68,64,37,30,39,34,42,592,66,54,35,538,70
1500000US530330029003,530330029003,"Block Group 3, Census Tract 29, King County, Washington",552,68,0,12,0,12,0,12,552,68,39,29,513,75
1500000US530330030001,530330030001,"Block Group 1, Census Tract 30, King County, Washington",626,87,25,28,25,28,0,12,601,95,99,54,502,94
1500000US530330030002,530330030002,"Block Group 2, Census Tract 30, King County, Washington",589,100,38,48,0,12,38,48,551,89,66,79,485,84
1500000US530330030003,530330030003,"Block Group 3, Census Tract 30, King County, Washington",659,103,48,44,48,44,0,12,611,113,94,61,517,113
1500000US530330030004,530330030004,"Block Group 4, Census Tract 30, King County, Washington",611,121,0,12,0,12,0,12,611,121,89,76,522,119
1500000US530330031001,530330031001,"Block Group 1, Census Tract 31, King County, Washington",444,73,0,12,0,12,0,12,444,73,76,54,368,85
1500000US530330031002,530330031002,"Block Group 2, Census Tract 31, King County, Washington",493,120,45,40,0,12,45,40,448,125,22,25,426,123
1500000US530330031003,530330031003,"Block Group 3, Census Tract 31, King County, Washington",600,122,30,27,30,27,0,12,570,123,102,60,468,131
1500000US530330031004,530330031004,"Block Group 4, Census Tract 31, King County, Washington",621,94,0,12,0,12,0,12,621,94,45,42,576,93
1500000US530330031005,530330031005,"Block Group 5, Census Tract 31, King County, Washington",515,74,30,35,0,12,30,35,485,77,47,38,438,86
1500000US530330032001,530330032001,"Block Group 1, Census Tract 32, King County, Washington",500,120,43,41,19,31,24,28,457,130,15,26,442,133
1500000US530330032002,530330032002,"Block Group 2, Census Tract 32, King County, Washington",895,178,31,34,16,24,15,24,864,183,112,72,752,181
1500000US530330032003,530330032003,"Block Group 3, Census Tract 32, King County, Washington",563,115,70,52,36,41,34,40,493,119,71,49,422,130
1500000US530330032004,530330032004,"Block Group 4, Census Tract 32, King County, Washington",652,156,50,43,14,23,36,42,602,155,112,67,490,152
1500000US530330032005,530330032005,"Block Group 5, Census Tract 32, King County, Washington",234,60,0,12,0,12,0,12,234,60,25,40,209,64
1500000US530330032006,530330032006,"Block Group 6, Census Tract 32, King County, Washington",725,151,78,110,0,12,78,110,647,136,93,54,554,151
1500000US530330032007,530330032007,"Block Group 7, Census Tract 32, King County, Washington",481,133,0,12,0,12,0,12,481,133,71,49,410,129
1500000US530330033001,530330033001,"Block Group 1, Census Tract 33, King County, Washington",638,77,46,42,14,23,32,36,592,88,30,34,562,98
1500000US530330033002,530330033002,"Block Group 2, Census Tract 33, King County, Washington",445,90,0,12,0,12,0,12,445,90,76,60,369,91
1500000US530330033003,530330033003,"Block Group 3, Census Tract 33, King County, Washington",910,125,70,57,0,12,70,57,840,130,56,53,784,137
1500000US530330033004,530330033004,"Block Group 4, Census Tract 33, King County, Washington",663,128,50,41,13,21,37,36,613,134,64,55,549,123
1500000US530330033005,530330033005,"Block Group 5, Census Tract 33, King County, Washington",549,112,46,44,0,12,46,44,503,115,25,30,478,119
1500000US530330034001,530330034001,"Block Group 1, Census Tract 34, King County, Washington",544,65,20,21,0,12,20,21,524,65,35,28,489,69
1500000US530330034002,530330034002,"Block Group 2, Census Tract 34, King County, Washington",519,87,0,12,0,12,0,12,519,87,50,30,469,89
1500000US530330034003,530330034003,"Block Group 3, Census Tract 34, King County, Washington",441,58,24,23,7,12,17,19,417,63,58,45,359,62
1500000US530330035001,530330035001,"Block Group 1, Census Tract 35, King County, Washington",628,68,23,21,16,18,7,12,605,72,70,35,535,76
1500000US530330035002,530330035002,"Block Group 2, Census Tract 35, King County, Washington",689,82,15,17,0,12,15,17,674,84,62,36,612,84
1500000US530330035003,530330035003,"Block Group 3, Census Tract 35, King County, Washington",559,97,0,12,0,12,0,12,559,97,118,60,441,88
1500000US530330036001,530330036001,"Block Group 1, Census Tract 36, King County, Washington",736,115,15,24,0,12,15,24,721,113,57,42,664,120
1500000US530330036002,530330036002,"Block Group 2, Census Tract 36, King County, Washington",785,142,94,51,63,48,31,35,691,139,58,47,633,144
1500000US530330036003,530330036003,"Block Group 3, Census Tract 36, King County, Washington",620,89,27,31,0,12,27,31,593,90,101,73,492,94
1500000US530330036004,530330036004,"Block Group 4, Census Tract 36, King County, Washington",1197,177,28,34,15,25,13,22,1169,175,279,142,890,160
1500000US530330038001,530330038001,"Block Group 1, Census Tract 38, King County, Washington",469,46,5,8,5,8,0,12,464,45,126,51,338,45
1500000US530330038002,530330038002,"Block Group 2, Census Tract 38, King County, Washington",378,44,10,13,10,13,0,12,368,46,51,26,317,49
1500000US530330039001,530330039001,"Block Group 1, Census Tract 39, King County, Washington",773,68,39,41,11,16,28,39,734,64,83,37,651,71
1500000US530330039002,530330039002,"Block Group 2, Census Tract 39, King County, Washington",401,40,0,12,0,12,0,12,401,40,34,26,367,45
1500000US530330040001,530330040001,"Block Group 1, Census Tract 40, King County, Washington",1007,80,168,52,56,33,112,45,839,81,70,39,769,89
1500000US530330040002,530330040002,"Block Group 2, Census Tract 40, King County, Washington",342,44,19,21,10,16,9,14,323,48,69,33,254,53
1500000US530330041001,530330041001,"Block Group 1, Census Tract 41, King County, Washington",607,102,20,30,0,12,20,30,587,97,38,35,549,100
1500000US530330041002,530330041002,"Block Group 2, Census Tract 41, King County, Washington",617,104,0,12,0,12,0,12,617,104,116,67,501,117
1500000US530330041003,530330041003,"Block Group 3, Census Tract 41, King County, Washington",435,81,0,12,0,12,0,12,435,81,47,43,388,88
1500000US530330041004,530330041004,"Block Group 4, Census Tract 41, King County, Washington",566,117,15,23,0,12,15,23,551,119,63,53,488,125
1500000US530330041005,530330041005,"Block Group 5, Census Tract 41, King County, Washington",394,86,29,34,0,12,29,34,365,84,34,28,331,86
1500000US530330041006,530330041006,"Block Group 6, Census Tract 41, King County, Washington",300,74,0,12,0,12,0,12,300,74,130,82,170,69
1500000US530330042001,530330042001,"Block Group 1, Census Tract 42, King County, Washington",739,115,0,12,0,12,0,12,739,115,32,37,707,120
1500000US530330042002,530330042002,"Block Group 2, Census Tract 42, King County, Washington",699,92,72,47,34,38,38,33,627,84,123,84,504,86
1500000US530330042003,530330042003,"Block Group 3, Census Tract 42, King County, Washington",771,97,61,73,45,68,16,24,710,110,97,69,613,109
1500000US530330042004,530330042004,"Block Group 4, Census Tract 42, King County, Washington",550,82,7,15,0,12,7,15,543,82,43,41,500,87
1500000US530330042005,530330042005,"Block Group 5, Census Tract 42, King County, Washington",558,87,14,22,0,12,14,22,544,90,0,12,544,90
1500000US530330043011,530330043011,"Block Group 1, Census Tract 43.01, King County, Washington",484,65,84,55,17,19,67,54,400,72,31,30,369,77
1500000US530330043012,530330043012,"Block Group 2, Census Tract 43.01, King County, Washington",455,69,7,12,7,12,0,12,448,68,45,29,403,71
1500000US530330043013,530330043013,"Block Group 3, Census Tract 43.01, King County, Washington",479,49,18,20,8,13,10,15,461,57,122,47,339,67
1500000US530330043021,530330043021,"Block Group 1, Census Tract 43.02, King County, Washington",619,104,78,64,0,12,78,64,541,103,59,54,482,103
1500000US530330043022,530330043022,"Block Group 2, Census Tract 43.02, King County, Washington",900,119,117,77,30,29,87,79,783,111,144,57,639,105
1500000US530330044001,530330044001,"Block Group 1, Census Tract 44, King County, Washington",394,83,15,23,0,12,15,23,379,80,0,12,379,80
1500000US530330044002,530330044002,"Block Group 2, Census Tract 44, King County, Washington",850,126,31,35,16,25,15,25,819,132,133,101,686,141
1500000US530330044003,530330044003,"Block Group 3, Census Tract 44, King County, Washington",493,101,85,74,14,22,71,70,408,98,44,42,364,107
1500000US530330044004,530330044004,"Block Group 4, Census Tract 44, King County, Washington",771,146,97,58,16,23,81,53,674,144,102,66,572,133
1500000US530330045001,530330045001,"Block Group 1, Census Tract 45, King County, Washington",330,58,11,18,0,12,11,18,319,59,11,18,308,59
1500000US530330045002,530330045002,"Block Group 2, Census Tract 45, King County, Washington",674,59,33,43,33,43,0,12,641,64,74,45,567,74
1500000US530330046001,530330046001,"Block Group 1, Census Tract 46, King County, Washington",484,76,7,11,0,12,7,11,477,76,30,28,447,80
1500000US530330046002,530330046002,"Block Group 2, Census Tract 46, King County, Washington",620,64,34,32,0,12,34,32,586,62,70,62,516,62
1500000US530330046003,530330046003,"Block Group 3, Census Tract 46, King County, Washington",337,49,0,12,0,12,0,12,337,49,15,17,322,54
1500000US530330047001,530330047001,"Block Group 1, Census Tract 47, King County, Washington",658,198,25,42,25,42,0,12,633,196,138,109,495,210
1500000US530330047002,530330047002,"Block Group 2, Census Tract 47, King County, Washington",956,180,0,12,0,12,0,12,956,180,0,12,956,180
1500000US530330047003,530330047003,"Block Group 3, Census Tract 47, King County, Washington",1783,228,93,90,64,74,29,46,1690,244,196,106,1494,225
1500000US530330047004,530330047004,"Block Group 4, Census Tract 47, King County, Washington",1701,243,54,63,0,12,54,63,1647,249,338,175,1309,255
1500000US530330048001,530330048001,"Block Group 1, Census Tract 48, King County, Washington",526,100,0,12,0,12,0,12,526,100,0,12,526,100
1500000US530330048002,530330048002,"Block Group 2, Census Tract 48, King County, Washington",643,89,27,30,0,12,27,30,616,89,93,68,523,89
1500000US530330048003,530330048003,"Block Group 3, Census Tract 48, King County, Washington",497,95,13,16,13,16,0,12,484,99,28,32,456,101
1500000US530330048004,530330048004,"Block Group 4, Census Tract 48, King County, Washington",515,89,0,12,0,12,0,12,515,89,44,41,471,99
1500000US530330049001,530330049001,"Block Group 1, Census Tract 49, King County, Washington",553,110,87,83,37,29,50,79,466,99,15,20,451,97
1500000US530330049002,530330049002,"Block Group 2, Census Tract 49, King County, Washington",810,115,66,83,50,79,16,25,744,111,28,34,716,112
1500000US530330049003,530330049003,"Block Group 3, Census Tract 49, King County, Washington",686,104,21,38,0,12,21,38,665,105,50,44,615,106
1500000US530330049004,530330049004,"Block Group 4, Census Tract 49, King County, Washington",721,110,14,24,0,12,14,24,707,115,17,27,690,120
1500000US530330049005,530330049005,"Block Group 5, Census Tract 49, King County, Washington",842,142,17,29,0,12,17,29,825,144,17,27,808,146
1500000US530330050001,530330050001,"Block Group 1, Census Tract 50, King County, Washington",690,113,28,26,9,13,19,22,662,120,53,54,609,119
1500000US530330050002,530330050002,"Block Group 2, Census Tract 50, King County, Washington",442,67,0,12,0,12,0,12,442,67,7,12,435,68
1500000US530330050003,530330050003,"Block Group 3, Census Tract 50, King County, Washington",848,123,55,39,13,20,42,33,793,123,141,65,652,127
1500000US530330051001,530330051001,"Block Group 1, Census Tract 51, King County, Washington",639,68,27,30,27,30,0,12,612,65,68,38,544,57
1500000US530330051002,530330051002,"Block Group 2, Census Tract 51, King County, Washington",496,51,13,14,13,14,0,12,483,53,81,38,402,62
1500000US530330051003,530330051003,"Block Group 3, Census Tract 51, King County, Washington",485,58,19,21,0,12,19,21,466,61,20,19,446,60
1500000US530330052001,530330052001,"Block Group 1, Census Tract 52, King County, Washington",404,132,35,41,18,29,17,28,369,130,31,34,338,131
1500000US530330052002,530330052002,"Block Group 2, Census Tract 52, King County, Washington",789,147,18,29,18,29,0,12,771,150,57,90,714,141
1500000US530330052003,530330052003,"Block Group 3, Census Tract 52, King County, Washington",528,103,0,12,0,12,0,12,528,103,52,50,476,111
1500000US530330052004,530330052004,"Block Group 4, Census Tract 52, King County, Washington",571,117,10,16,0,12,10,16,561,120,71,72,490,120
1500000US530330052005,530330052005,"Block Group 5, Census Tract 52, King County, Washington",648,143,94,39,54,39,40,32,554,136,56,50,498,141
1500000US530330053011,530330053011,"Block Group 1, Census Tract 53.01, King County, Washington",289,100,23,30,14,23,9,19,266,97,0,12,266,97
1500000US530330053012,530330053012,"Block Group 2, Census Tract 53.01, King County, Washington",1157,162,146,58,91,57,55,49,1011,174,109,102,902,159
1500000US530330053013,530330053013,"Block Group 3, Census Tract 53.01, King County, Washington",547,101,0,12,0,12,0,12,547,101,13,21,534,101
1500000US530330053014,530330053014,"Block Group 4, Census Tract 53.01, King County, Washington",815,149,45,72,0,12,45,72,770,147,99,85,671,140
1500000US530330053021,530330053021,"Block Group 1, Census Tract 53.02, King County, Washington",116,27,14,12,5,7,9,9,102,27,0,12,102,27
1500000US530330053022,530330053022,"Block Group 2, Census Tract 53.02, King County, Washington",17,16,0,12,0,12,0,12,17,16,0,12,17,16
1500000US530330053023,530330053023,"Block Group 3, Census Tract 53.02, King County, Washington",0,12,0,12,0,12,0,12,0,12,0,12,0,12
1500000US530330054001,530330054001,"Block Group 1, Census Tract 54, King County, Washington",457,93,11,18,11,18,0,12,446,92,0,12,446,92
1500000US530330054002,530330054002,"Block Group 2, Census Tract 54, King County, Washington",687,127,11,18,0,12,11,18,676,127,51,47,625,132
1500000US530330054003,530330054003,"Block Group 3, Census Tract 54, King County, Washington",721,127,71,96,0,12,71,96,650,115,59,45,591,116
1500000US530330054004,530330054004,"Block Group 4, Census Tract 54, King County, Washington",1019,122,36,42,0,12,36,42,983,131,0,12,983,131
1500000US530330056001,530330056001,"Block Group 1, Census Tract 56, King County, Washington",555,75,0,12,0,12,0,12,555,75,47,41,508,88
1500000US530330056002,530330056002,"Block Group 2, Census Tract 56, King County, Washington",567,96,0,12,0,12,0,12,567,96,152,79,415,101
1500000US530330056003,530330056003,"Block Group 3, Census Tract 56, King County, Washington",435,84,0,12,0,12,0,12,435,84,88,49,347,83
1500000US530330056004,530330056004,"Block Group 4, Census Tract 56, King County, Washington",478,82,17,26,17,26,0,12,461,81,109,67,352,93
1500000US530330056005,530330056005,"Block Group 5, Census Tract 56, King County, Washington",582,103,0,12,0,12,0,12,582,103,47,42,535,109
1500000US530330057001,530330057001,"Block Group 1, Census Tract 57, King County, Washington",189,80,0,12,0,12,0,12,189,80,29,33,160,87
1500000US530330057002,530330057002,"Block Group 2, Census Tract 57, King County, Washington",472,77,0,12,0,12,0,12,472,77,52,48,420,89
1500000US530330057003,530330057003,"Block Group 3, Census Tract 57, King County, Washington",425,88,14,23,0,12,14,23,411,93,33,37,378,90
1500000US530330057004,530330057004,"Block Group 4, Census Tract 57, King County, Washington",433,104,0,12,0,12,0,12,433,104,91,56,342,102
1500000US530330057005,530330057005,"Block Group 5, Census Tract 57, King County, Washington",478,100,0,12,0,12,0,12,478,100,102,64,376,92
1500000US530330057006,530330057006,"Block Group 6, Census Tract 57, King County, Washington",752,110,42,41,28,33,14,24,710,110,51,50,659,119
1500000US530330058011,530330058011,"Block Group 1, Census Tract 58.01, King County, Washington",566,106,0,12,0,12,0,12,566,106,30,34,536,97
1500000US530330058012,530330058012,"Block Group 2, Census Tract 58.01, King County, Washington",797,115,0,12,0,12,0,12,797,115,94,63,703,122
1500000US530330058013,530330058013,"Block Group 3, Census Tract 58.01, King County, Washington",654,89,0,12,0,12,0,12,654,89,112,66,542,99
1500000US530330058014,530330058014,"Block Group 4, Census Tract 58.01, King County, Washington",677,127,141,108,32,38,109,104,536,116,45,41,491,114
1500000US530330058021,530330058021,"Block Group 1, Census Tract 58.02, King County, Washington",697,133,0,12,0,12,0,12,697,133,55,46,642,138
1500000US530330058022,530330058022,"Block Group 2, Census Tract 58.02, King County, Washington",1247,170,77,47,0,12,77,47,1170,174,170,98,1000,171
1500000US530330058023,530330058023,"Block Group 3, Census Tract 58.02, King County, Washington",857,140,175,122,61,75,114,95,682,140,53,48,629,142
1500000US530330059001,530330059001,"Block Group 1, Census Tract 59, King County, Washington",840,155,53,48,53,48,0,12,787,152,57,60,730,144
1500000US530330059002,530330059002,"Block Group 2, Census Tract 59, King County, Washington",591,133,0,12,0,12,0,12,591,133,44,35,547,132
1500000US530330059003,530330059003,"Block Group 3, Census Tract 59, King County, Washington",212,106,0,12,0,12,0,12,212,106,11,19,201,105
1500000US530330059004,530330059004,"Block Group 4, Census Tract 59, King County, Washington",614,118,0,12,0,12,0,12,614,118,0,12,614,118
1500000US530330059005,530330059005,"Block Group 5, Census Tract 59, King County, Washington",452,112,11,17,0,12,11,17,441,115,37,34,404,117
1500000US530330060001,530330060001,"Block Group 1, Census Tract 60, King County, Washington",837,133,44,48,26,40,18,28,793,144,137,62,656,144
1500000US530330060002,530330060002,"Block Group 2, Census Tract 60, King County, Washington",590,114,0,12,0,12,0,12,590,114,38,30,552,118
1500000US530330060003,530330060003,"Block Group 3, Census Tract 60, King County, Washington",460,118,11,18,11,18,0,12,449,120,7,14,442,120
1500000US530330060004,530330060004,"Block Group 4, Census Tract 60, King County, Washington",623,98,0,12,0,12,0,12,623,98,97,83,526,96
1500000US530330061001,530330061001,"Block Group 1, Census Tract 61, King County, Washington",575,94,0,12,0,12,0,12,575,94,0,12,575,94
1500000US530330061002,530330061002,"Block Group 2, Census Tract 61, King County, Washington",543,104,13,21,0,12,13,21,530,102,110,69,420,103
1500000US530330061003,530330061003,"Block Group 3, Census Tract 61, King County, Washington",861,121,0,12,0,12,0,12,861,121,15,24,846,121
1500000US530330061004,530330061004,"Block Group 4, Census Tract 61, King County, Washington",943,141,43,41,15,25,28,33,900,142,79,78,821,141
1500000US530330062001,530330062001,"Block Group 1, Census Tract 62, King County, Washington",568,53,56,32,30,29,26,24,512,56,34,24,478,56
1500000US530330062002,530330062002,"Block Group 2, Census Tract 62, King County, Washington",628,53,9,13,0,12,9,13,619,54,34,27,585,59
1500000US530330062003,530330062003,"Block Group 3, Census Tract 62, King County, Washington",419,41,6,10,0,12,6,10,413,41,9,14,404,42
1500000US530330063001,530330063001,"Block Group 1, Census Tract 63, King County, Washington",800,149,0,12,0,12,0,12,800,149,121,87,679,143
1500000US530330063002,530330063002,"Block Group 2, Census Tract 63, King County, Washington",650,108,0,12,0,12,0,12,650,108,150,75,500,116
1500000US530330063003,530330063003,"Block Group 3, Census Tract 63, King County, Washington",585,110,0,12,0,12,0,12,585,110,112,82,473,120
1500000US530330063004,530330063004,"Block Group 4, Census Tract 63, King County, Washington",479,71,0,12,0,12,0,12,479,71,109,67,370,80
1500000US530330064001,530330064001,"Block Group 1, Census Tract 64, King County, Washington",471,65,0,12,0,12,0,12,471,65,29,23,442,66
1500000US530330064002,530330064002,"Block Group 2, Census Tract 64, King County, Washington",381,51,0,12,0,12,0,12,381,51,26,23,355,59
1500000US530330064003,530330064003,"Block Group 3, Census Tract 64, King County, Washington",492,74,37,55,37,55,0,12,455,67,76,63,379,57
1500000US530330065001,530330065001,"Block Group 1, Census Tract 65, King County, Washington",503,106,0,12,0,12,0,12,503,106,52,51,451,105
1500000US530330065002,530330065002,"Block Group 2, Census Tract 65, King County, Washington",1125,160,0,12,0,12,0,12,1125,160,122,73,1003,152
1500000US530330065003,530330065003,"Block Group 3, Census Tract 65, King County, Washington",780,132,42,52,30,47,12,21,738,134,63,40,675,143
1500000US530330066001,530330066001,"Block Group 1, Census Tract 66, King County, Washington",1075,166,0,12,0,12,0,12,1075,166,87,60,988,179
1500000US530330066002,530330066002,"Block Group 2, Census Tract 66, King County, Washington",1083,143,97,88,8,13,89,84,986,156,85,59,901,154
1500000US530330067001,530330067001,"Block Group 1, Census Tract 67, King County, Washington",1355,203,0,12,0,12,0,12,1355,203,47,45,1308,209
1500000US530330067002,530330067002,"Block Group 2, Census Tract 67, King County, Washington",1248,181,0,12,0,12,0,12,1248,181,144,106,1104,178
1500000US530330067003,530330067003,"Block Group 3, Census Tract 67, King County, Washington",876,194,0,12,0,12,0,12,876,194,25,42,851,191
1500000US530330067004,530330067004,"Block Group 4, Census Tract 67, King County, Washington",991,176,28,44,0,12,28,44,963,178,162,110,801,184
1500000US530330068001,530330068001,"Block Group 1, Census Tract 68, King County, Washington",583,80,13,16,3,7,10,14,570,83,69,56,501,74
1500000US530330068002,530330068002,"Block Group 2, Census Tract 68, King County, Washington",834,78,33,28,22,23,11,15,801,87,55,35,746,93
1500000US530330069001,530330069001,"Block Group 1, Census Tract 69, King County, Washington",473,88,16,27,16,27,0,12,457,85,66,52,391,86
1500000US530330069002,530330069002,"Block Group 2, Census Tract 69, King County, Washington",528,80,0,12,0,12,0,12,528,80,64,50,464,91
1500000US530330069003,530330069003,"Block Group 3, Census Tract 69, King County, Washington",485,98,46,48,30,41,16,25,439,89,70,48,369,81
1500000US530330069004,530330069004,"Block Group 4, Census Tract 69, King County, Washington",729,107,0,12,0,12,0,12,729,107,50,45,679,107
1500000US530330070001,530330070001,"Block Group 1, Census Tract 70, King County, Washington",609,155,0,12,0,12,0,12,609,155,44,51,565,163
1500000US530330070002,530330070002,"Block Group 2, Census Tract 70, King County, Washington",984,212,78,75,0,12,78,75,906,224,120,152,786,188
1500000US530330070003,530330070003,"Block Group 3, Census Tract 70, King County, Washington",1160,212,62,59,40,47,22,34,1098,220,257,192,841,194
1500000US530330070004,530330070004,"Block Group 4, Census Tract 70, King County, Washington",706,130,54,43,54,43,0,12,652,132,15,24,637,133
1500000US530330070005,530330070005,"Block Group 5, Census Tract 70, King County, Washington",729,172,50,59,23,36,27,46,679,164,100,73,579,161
1500000US530330070006,530330070006,"Block Group 6, Census Tract 70, King County, Washington",807,130,54,45,25,40,29,47,753,136,50,58,703,143
1500000US530330071001,530330071001,"Block Group 1, Census Tract 71, King County, Washington",1067,146,130,87,46,43,84,79,937,146,26,32,911,156
1500000US530330071002,530330071002,"Block Group 2, Census Tract 71, King County, Washington",1619,178,0,12,0,12,0,12,1619,178,151,76,1468,182
1500000US530330072001,530330072001,"Block Group 1, Census Tract 72, King County, Washington",2967,300,195,97,107,70,88,74,2772,305,230,129,2542,314
1500000US530330072002,530330072002,"Block Group 2, Census Tract 72, King County, Washington",1039,189,0,12,0,12,0,12,1039,189,39,47,1000,190
1500000US530330072003,530330072003,"Block Group 3, Census Tract 72, King County, Washington",1407,244,217,141,64,53,153,145,1190,260,75,58,1115,259
1500000US530330073001,530330073001,"Block Group 1, Census Tract 73, King County, Washington",1651,220,132,72,40,47,92,56,1519,211,134,104,1385,195
1500000US530330073002,530330073002,"Block Group 2, Census Tract 73, King County, Washington",1263,180,272,151,65,59,207,136,991,165,231,111,760,142
1500000US530330073003,530330073003,"Block Group 3, Census Tract 73, King County, Washington",1085,200,48,41,28,25,20,32,1037,197,122,120,915,178
1500000US530330074011,530330074011,"Block Group 1, Census Tract 74.01, King County, Washington",810,121,9,16,9,16,0,12,801,122,63,69,738,120
1500000US530330074012,530330074012,"Block Group 2, Census Tract 74.01, King County, Washington",953,147,115,60,76,50,39,44,838,138,34,38,804,142
1500000US530330074013,530330074013,"Block Group 3, Census Tract 74.01, King County, Washington",877,143,12,20,0,12,12,20,865,144,141,97,724,143
1500000US530330074014,530330074014,"Block Group 4, Census Tract 74.01, King County, Washington",919,143,34,38,16,25,18,28,885,143,52,47,833,158
1500000US530330074021,530330074021,"Block Group 1, Census Tract 74.02, King County, Washington",1330,169,45,45,14,24,31,35,1285,165,54,87,1231,163
1500000US530330074022,530330074022,"Block Group 2, Census Tract 74.02, King County, Washington",1041,199,191,113,79,70,112,94,850,187,74,70,776,180
1500000US530330074023,530330074023,"Block Group 3, Census Tract 74.02, King County, Washington",1143,164,222,78,144,68,78,55,921,176,86,79,835,171
1500000US530330075001,530330075001,"Block Group 1, Census Tract 75, King County, Washington",1025,193,160,121,29,46,131,113,865,188,103,133,762,169
1500000US530330075002,530330075002,"Block Group 2, Census Tract 75, King County, Washington",887,178,48,54,27,42,21,33,839,189,75,72,764,189
1500000US530330075003,530330075003,"Block Group 3, Census Tract 75, King County, Washington",1075,197,31,50,31,50,0,12,1044,202,104,109,940,196
1500000US530330075004,530330075004,"Block Group 4, Census Tract 75, King County, Washington",1471,228,96,71,23,38,73,64,1375,223,238,167,1137,269
1500000US530330075005,530330075005,"Block Group 5, Census Tract 75, King County, Washington",778,179,0,12,0,12,0,12,778,179,78,67,700,191
1500000US530330076001,530330076001,"Block Group 1, Census Tract 76, King County, Washington",610,108,22,21,8,13,14,23,588,107,7,12,581,107
1500000US530330076002,530330076002,"Block Group 2, Census Tract 76, King County, Washington",781,108,93,62,16,18,77,60,688,118,146,100,542,100
1500000US530330076003,530330076003,"Block Group 3, Census Tract 76, King County, Washington",688,109,7,11,0,12,7,11,681,108,16,26,665,107
1500000US530330077001,530330077001,"Block Group 1, Census Tract 77, King County, Washington",551,92,23,35,0,12,23,35,528,94,60,57,468,90
1500000US530330077002,530330077002,"Block Group 2, Census Tract 77, King County, Washington",412,66,0,12,0,12,0,12,412,66,55,45,357,77
1500000US530330077003,530330077003,"Block Group 3, Census Tract 77, King County, Washington",361,79,52,47,0,12,52,47,309,84,0,12,309,84
1500000US530330077004,530330077004,"Block Group 4, Census Tract 77, King County, Washington",973,128,102,109,20,31,82,105,871,121,36,42,835,129
1500000US530330078001,530330078001,"Block Group 1, Census Tract 78, King County, Washington",580,123,12,21,0,12,12,21,568,121,67,49,501,127
1500000US530330078002,530330078002,"Block Group 2, Census Tract 78, King County, Washington",596,97,0,12,0,12,0,12,596,97,118,87,478,88
1500000US530330078003,530330078003,"Block Group 3, Census Tract 78, King County, Washington",590,87,83,72,15,23,68,67,507,100,7,13,500,100
1500000US530330078004,530330078004,"Block Group 4, Census Tract 78, King County, Washington",466,88,49,68,39,57,10,22,417,83,4,9,413,83
1500000US530330079001,530330079001,"Block Group 1, Census Tract 79, King County, Washington",415,119,17,31,4,19,13,20,398,116,74,74,324,117
1500000US530330079002,530330079002,"Block Group 2, Census Tract 79, King County, Washington",431,98,152,90,88,78,64,53,279,82,13,22,266,81
1500000US530330079003,530330079003,"Block Group 3, Census Tract 79, King County, Washington",440,104,33,37,0,12,33,37,407,105,39,45,368,104
1500000US530330079004,530330079004,"Block Group 4, Census Tract 79, King County, Washington",873,116,180,116,105,66,75,96,693,124,153,80,540,135
1500000US530330079005,530330079005,"Block Group 5, Census Tract 79, King County, Washington",956,139,83,52,36,40,47,39,873,138,113,71,760,143
1500000US530330080011,530330080011,"Block Group 1, Census Tract 80.01, King County, Washington",1014,249,46,69,46,69,0,12,968,253,34,40,934,258
1500000US530330080012,530330080012,"Block Group 2, Census Tract 80.01, King County, Washington",755,211,94,84,31,49,63,67,661,228,174,168,487,180
1500000US530330080013,530330080013,"Block Group 3, Census Tract 80.01, King County, Washington",883,181,100,68,49,55,51,58,783,187,48,55,735,196
1500000US530330080014,530330080014,"Block Group 4, Census Tract 80.01, King County, Washington",1000,226,78,42,51,58,27,44,922,219,0,12,922,219
1500000US530330080015,530330080015,"Block Group 5, Census Tract 80.01, King County, Washington",712,251,21,35,21,35,0,12,691,255,74,91,617,244
1500000US530330080021,530330080021,"Block Group 1, Census Tract 80.02, King County, Washington",1291,154,558,150,311,129,247,111,733,125,121,82,612,116
1500000US530330080022,530330080022,"Block Group 2, Census Tract 80.02, King County, Washington",1052,151,223,114,101,89,122,84,829,158,69,47,760,167
1500000US530330081001,530330081001,"Block Group 1, Census Tract 81, King County, Washington",1295,191,41,65,0,12,41,65,1254,197,129,78,1125,208
1500000US530330081002,530330081002,"Block Group 2, Census Tract 81, King County, Washington",484,133,124,70,72,55,52,52,360,125,48,76,312,100
1500000US530330081003,530330081003,"Block Group 3, Census Tract 81, King County, Washington",800,135,214,90,146,89,68,46,586,131,115,74,471,113
1500000US530330082001,530330082001,"Block Group 1, Census Tract 82, King County, Washington",978,148,110,98,93,93,17,26,868,151,84,89,784,131
1500000US530330082002,530330082002,"Block Group 2, Census Tract 82, King County, Washington",926,162,85,93,0,12,85,93,841,149,81,54,760,161
1500000US530330082003,530330082003,"Block Group 3, Census Tract 82, King County, Washington",780,117,60,64,7,11,53,62,720,116,186,74,534,115
1500000US530330083001,530330083001,"Block Group 1, Census Tract 83, King County, Washington",938,92,118,61,70,60,48,26,820,101,37,29,783,102
1500000US530330083002,530330083002,"Block Group 2, Census Tract 83, King County, Washington",1147,95,82,52,29,26,53,48,1065,113,128,56,937,104
1500000US530330084001,530330084001,"Block Group 1, Census Tract 84, King County, Washington",1005,153,38,38,13,21,25,30,967,143,53,36,914,145
1500000US530330084002,530330084002,"Block Group 2, Census Tract 84, King County, Washington",1107,138,148,109,61,77,87,81,959,129,165,70,794,136
1500000US530330084003,530330084003,"Block Group 3, Census Tract 84, King County, Washington",928,150,82,48,31,35,51,41,846,160,93,74,753,153
1500000US530330085001,530330085001,"Block Group 1, Census Tract 85, King County, Washington",924,91,77,44,30,28,47,35,847,93,278,66,569,83
1500000US530330085002,530330085002,"Block Group 2, Census Tract 85, King County, Washington",559,96,103,66,49,45,54,54,456,91,136,63,320,76
1500000US530330085003,530330085003,"Block Group 3, Census Tract 85, King County, Washington",405,80,306,83,191,73,115,68,99,64,15,17,84,63
1500000US530330086001,530330086001,"Block Group 1, Census Tract 86, King County, Washington",762,115,129,76,93,60,36,43,633,120,97,58,536,123
1500000US530330086002,530330086002,"Block Group 2, Census Tract 86, King County, Washington",705,110,22,25,22,25,0,12,683,109,28,34,655,110
1500000US530330086003,530330086003,"Block Group 3, Census Tract 86, King County, Washington",503,92,147,53,102,46,45,36,356,86,0,12,356,86
1500000US530330087001,530330087001,"Block Group 1, Census Tract 87, King County, Washington",656,110,57,47,0,12,57,47,599,111,107,63,492,113
1500000US530330087002,530330087002,"Block Group 2, Census Tract 87, King County, Washington",483,106,95,60,79,64,16,16,388,101,57,53,331,94
1500000US530330087003,530330087003,"Block Group 3, Census Tract 87, King County, Washington",658,90,154,65,47,30,107,61,504,99,38,30,466,98
1500000US530330088001,530330088001,"Block Group 1, Census Tract 88, King County, Washington",630,78,67,50,46,43,21,33,563,75,51,41,512,74
1500000US530330088002,530330088002,"Block Group 2, Census Tract 88, King County, Washington",497,67,45,35,18,26,27,23,452,71,75,49,377,72
1500000US530330088003,530330088003,"Block Group 3, Census Tract 88, King County, Washington",443,87,88,72,33,39,55,60,355,79,47,35,308,80
1500000US530330089001,530330089001,"Block Group 1, Census Tract 89, King County, Washington",612,153,6,14,6,14,0,12,606,154,118,63,488,150
1500000US530330089002,530330089002,"Block Group 2, Census Tract 89, King County, Washington",588,116,88,90,51,85,37,33,500,105,100,69,400,107
1500000US530330089003,530330089003,"Block Group 3, Census Tract 89, King County, Washington",567,142,219,134,174,145,45,45,348,98,0,12,348,98
1500000US530330089004,530330089004,"Block Group 4, Census Tract 89, King County, Washington",460,130,50,60,50,60,0,12,410,121,59,97,351,118
1500000US530330090001,530330090001,"Block Group 1, Census Tract 90, King County, Washington",723,92,87,50,41,40,46,41,636,110,128,59,508,99
1500000US530330090002,530330090002,"Block Group 2, Census Tract 90, King County, Washington",1024,85,278,94,160,79,118,66,746,95,195,63,551,87
1500000US530330091001,530330091001,"Block Group 1, Census Tract 91, King County, Washington",482,87,147,76,32,29,115,72,335,86,78,37,257,80
1500000US530330091002,530330091002,"Block Group 2, Census Tract 91, King County, Washington",1011,108,259,83,155,80,104,60,752,106,128,59,624,112
1500000US530330092001,530330092001,"Block Group 1, Census Tract 92, King County, Washington",938,109,346,83,229,80,117,57,592,100,132,69,460,84
1500000US530330092002,530330092002,"Block Group 2, Census Tract 92, King County, Washington",790,103,320,105,225,98,95,63,470,97,130,72,340,93
1500000US530330093001,530330093001,"Block Group 1, Census Tract 93, King County, Washington",476,63,67,44,23,19,44,39,409,63,52,25,357,67
1500000US530330093002,530330093002,"Block Group 2, Census Tract 93, King County, Washington",192,38,10,12,0,12,10,12,182,37,37,25,145,35
1500000US530330093003,530330093003,"Block Group 3, Census Tract 93, King County, Washington",439,64,34,28,34,28,0,12,405,64,27,24,378,69
1500000US530330094001,530330094001,"Block Group 1, Census Tract 94, King County, Washington",623,133,216,80,124,71,92,78,407,124,27,30,380,125
1500000US530330094002,530330094002,"Block Group 2, Census Tract 94, King County, Washington",687,134,242,116,106,83,136,84,445,108,28,32,417,115
1500000US530330094003,530330094003,"Block Group 3, Census Tract 94, King County, Washington",409,109,87,76,31,33,56,68,322,97,32,39,290,100
1500000US530330094004,530330094004,"Block Group 4, Census Tract 94, King County, Washington",311,104,17,27,17,27,0,12,294,100,67,47,227,102
1500000US530330094005,530330094005,"Block Group 5, Census Tract 94, King County, Washington",497,131,102,87,27,37,75,85,395,129,30,33,365,125
1500000US530330095001,530330095001,"Block Group 1, Census Tract 95, King County, Washington",758,119,0,12,0,12,0,12,758,119,125,102,633,119
1500000US530330095002,530330095002,"Block Group 2, Census Tract 95, King County, Washington",838,159,246,121,175,122,71,68,592,160,100,81,492,157
1500000US530330095003,530330095003,"Block Group 3, Census Tract 95, King County, Washington",450,83,13,21,13,21,0,12,437,87,43,38,394,89
1500000US530330095004,530330095004,"Block Group 4, Census Tract 95, King County, Washington",578,158,234,137,102,73,132,120,344,93,65,56,279,84
1500000US530330096001,530330096001,"Block Group 1, Census Tract 96, King County, Washington",269,59,0,12,0,12,0,12,269,59,50,46,219,72
1500000US530330096002,530330096002,"Block Group 2, Census Tract 96, King County, Washington",718,132,35,42,14,22,21,34,683,139,104,46,579,145
1500000US530330096003,530330096003,"Block Group 3, Census Tract 96, King County, Washington",573,126,17,26,17,26,0,12,556,125,43,38,513,132
1500000US530330096004,530330096004,"Block Group 4, Census Tract 96, King County, Washington",470,94,25,31,12,23,13,20,445,101,78,82,367,98
1500000US530330096005,530330096005,"Block Group 5, Census Tract 96, King County, Washington",710,102,0,12,0,12,0,12,710,102,70,70,640,108
1500000US530330097011,530330097011,"Block Group 1, Census Tract 97.01, King County, Washington",937,166,17,28,0,12,17,28,920,165,75,47,845,176
1500000US530330097012,530330097012,"Block Group 2, Census Tract 97.01, King County, Washington",520,111,16,26,16,26,0,12,504,107,51,49,453,112
1500000US530330097013,530330097013,"Block Group 3, Census Tract 97.01, King County, Washington",660,127,19,31,0,12,19,31,641,123,166,102,475,113
1500000US530330097014,530330097014,"Block Group 4, Census Tract 97.01, King County, Washington",943,140,30,35,30,35,0,12,913,137,154,102,759,137
1500000US530330097021,530330097021,"Block Group 1, Census Tract 97.02, King County, Washington",641,80,12,17,0,12,12,17,629,79,120,58,509,79
1500000US530330097022,530330097022,"Block Group 2, Census Tract 97.02, King County, Washington",401,72,17,27,0,12,17,27,384,71,93,64,291,81
1500000US530330097023,530330097023,"Block Group 3, Census Tract 97.02, King County, Washington",339,64,0,12,0,12,0,12,339,64,25,28,314,70
1500000US530330097024,530330097024,"Block Group 4, Census Tract 97.02, King County, Washington",372,72,20,32,0,12,20,32,352,74,77,52,275,65
1500000US530330097025,530330097025,"Block Group 5, Census Tract 97.02, King County, Washington",585,89,0,12,0,12,0,12,585,89,102,58,483,91
1500000US530330098001,530330098001,"Block Group 1, Census Tract 98, King County, Washington",544,90,13,21,13,21,0,12,531,90,32,38,499,88
1500000US530330098002,530330098002,"Block Group 2, Census Tract 98, King County, Washington",554,94,15,25,0,12,15,25,539,95,95,58,444,106
1500000US530330098003,530330098003,"Block Group 3, Census Tract 98, King County, Washington",608,75,17,28,17,28,0,12,591,76,50,46,541,86
1500000US530330098004,530330098004,"Block Group 4, Census Tract 98, King County, Washington",627,93,39,36,0,12,39,36,588,102,141,83,447,105
1500000US530330098005,530330098005,"Block Group 5, Census Tract 98, King County, Washington",713,113,0,12,0,12,0,12,713,113,92,97,621,125
1500000US530330099001,530330099001,"Block Group 1, Census Tract 99, King County, Washington",579,109,72,85,0,12,72,85,507,89,79,59,428,104
1500000US530330099002,530330099002,"Block Group 2, Census Tract 99, King County, Washington",844,157,49,55,15,23,34,51,795,153,77,62,718,155
1500000US530330099003,530330099003,"Block Group 3, Census Tract 99, King County, Washington",898,123,92,74,75,72,17,27,806,121,82,55,724,129
1500000US530330099004,530330099004,"Block Group 4, Census Tract 99, King County, Washington",481,82,14,23,14,23,0,12,467,80,73,59,394,87
1500000US530330100011,530330100011,"Block Group 1, Census Tract 100.01, King County, Washington",399,86,29,30,16,19,13,22,370,87,46,39,324,88
1500000US530330100012,530330100012,"Block Group 2, Census Tract 100.01, King County, Washington",495,89,32,28,8,15,24,23,463,91,31,30,432,93
1500000US530330100013,530330100013,"Block Group 3, Census Tract 100.01, King County, Washington",645,99,202,86,119,64,83,64,443,92,76,50,367,94
1500000US530330100021,530330100021,"Block Group 1, Census Tract 100.02, King County, Washington",401,100,56,50,49,49,7,11,345,105,61,48,284,100
1500000US530330100022,530330100022,"Block Group 2, Census Tract 100.02, King County, Washington",644,92,129,62,27,34,102,61,515,94,79,47,436,91
1500000US530330100023,530330100023,"Block Group 3, Census Tract 100.02, King County, Washington",324,53,29,27,9,14,20,24,295,57,73,40,222,56
1500000US530330100024,530330100024,"Block Group 4, Census Tract 100.02, King County, Washington",449,84,55,44,12,17,43,42,394,85,113,63,281,90
1500000US530330101001,530330101001,"Block Group 1, Census Tract 101, King County, Washington",413,109,77,110,77,110,0,12,336,74,19,30,317,79
1500000US530330101002,530330101002,"Block Group 2, Census Tract 101, King County, Washington",360,89,55,62,19,31,36,56,305,74,40,46,265,67
1500000US530330101003,530330101003,"Block Group 3, Census Tract 101, King County, Washington",589,147,291,102,179,117,112,75,298,123,37,40,261,126
1500000US530330101004,530330101004,"Block Group 4, Census Tract 101, King County, Washington",802,184,111,76,53,49,58,63,691,201,177,110,514,180
1500000US530330101005,530330101005,"Block Group 5, Census Tract 101, King County, Washington",776,132,249,119,154,116,95,71,527,116,26,39,501,110
1500000US530330102001,530330102001,"Block Group 1, Census Tract 102, King County, Washington",623,64,11,17,11,17,0,12,612,66,57,35,555,66
1500000US530330102002,530330102002,"Block Group 2, Census Tract 102, King County, Washington",406,54,0,12,0,12,0,12,406,54,59,39,347,59
1500000US530330102003,530330102003,"Block Group 3, Census Tract 102, King County, Washington",385,70,48,38,15,20,33,30,337,80,87,54,250,65
1500000US530330102004,530330102004,"Block Group 4, Census Tract 102, King County, Washington",514,62,20,19,20,19,0,12,494,64,25,23,469,63
1500000US530330103001,530330103001,"Block Group 1, Census Tract 103, King County, Washington",418,107,47,70,0,12,47,70,371,105,12,21,359,108
1500000US530330103002,530330103002,"Block Group 2, Census Tract 103, King County, Washington",534,128,78,56,60,48,18,28,456,131,49,44,407,132
1500000US530330103003,530330103003,"Block Group 3, Census Tract 103, King County, Washington",414,131,115,82,39,39,76,76,299,116,81,59,218,104
1500000US530330103004,530330103004,"Block Group 4, Census Tract 103, King County, Washington",495,140,274,140,128,104,146,100,221,99,10,16,211,97
1500000US530330103005,530330103005,"Block Group 5, Census Tract 103, King County, Washington",737,157,106,82,79,80,27,28,631,151,13,20,618,148
1500000US530330104011,530330104011,"Block Group 1, Census Tract 104.01, King County, Washington",469,69,22,27,13,21,9,15,447,74,64,39,383,73
1500000US530330104012,530330104012,"Block Group 2, Census Tract 104.01, King County, Washington",589,73,96,54,30,35,66,43,493,77,119,57,374,83
1500000US530330104013,530330104013,"Block Group 3, Census Tract 104.01, King County, Washington",359,72,74,48,47,40,27,26,285,65,72,39,213,56
1500000US530330104021,530330104021,"Block Group 1, Census Tract 104.02, King County, Washington",376,65,80,42,53,35,27,26,296,66,34,30,262,66
1500000US530330104022,530330104022,"Block Group 2, Census Tract 104.02, King County, Washington",448,69,29,28,9,16,20,25,419,73,111,55,308,71
1500000US530330104023,530330104023,"Block Group 3, Census Tract 104.02, King County, Washington",333,88,35,44,35,44,0,12,298,82,41,35,257,79
1500000US530330104024,530330104024,"Block Group 4, Census Tract 104.02, King County, Washington",504,88,22,26,11,18,11,17,482,90,68,35,414,91
1500000US530330105001,530330105001,"Block Group 1, Census Tract 105, King County, Washington",649,156,29,32,0,12,29,32,620,158,239,121,381,111
1500000US530330105002,530330105002,"Block Group 2, Census Tract 105, King County, Washington",515,94,17,26,0,12,17,26,498,98,16,26,482,101
1500000US530330105003,530330105003,"Block Group 3, Census Tract 105, King County, Washington",457,107,10,18,0,12,10,18,447,108,78,56,369,116
1500000US530330105004,530330105004,"Block Group 4, Census Tract 105, King County, Washington",1183,178,118,76,66,64,52,41,1065,184,125,80,940,187
1500000US530330105005,530330105005,"Block Group 5, Census Tract 105, King County, Washington",772,112,10,17,10,17,0,12,762,115,83,78,679,104
1500000US530330106001,530330106001,"Block Group 1, Census Tract 106, King County, Washington",709,112,14,22,0,12,14,22,695,114,133,80,562,99
1500000US530330106002,530330106002,"Block Group 2, Census Tract 106, King County, Washington",520,92,13,22,13,22,0,12,507,95,14,22,493,96
1500000US530330106003,530330106003,"Block Group 3, Census Tract 106, King County, Washington",742,120,90,70,14,22,76,69,652,110,54,52,598,121
1500000US530330106004,530330106004,"Block Group 4, Census Tract 106, King County, Washington",461,119,21,33,0,12,21,33,440,117,58,45,382,126
1500000US530330106005,530330106005,"Block Group 5, Census Tract 106, King County, Washington",747,110,54,52,54,52,0,12,693,109,143,65,550,108
1500000US530330106006,530330106006,"Block Group 6, Census Tract 106, King County, Washington",420,72,16,25,0,12,16,25,404,76,63,49,341,71
1500000US530330107011,530330107011,"Block Group 1, Census Tract 107.01, King County, Washington",867,94,290,95,29,27,261,95,577,91,71,54,506,80
1500000US530330107012,530330107012,"Block Group 2, Census Tract 107.01, King County, Washington",533,80,93,62,6,11,87,61,440,83,49,37,391,81
1500000US530330107021,530330107021,"Block Group 1, Census Tract 107.02, King County, Washington",434,85,48,40,48,40,0,12,386,80,18,23,368,77
1500000US530330107022,530330107022,"Block Group 2, Census Tract 107.02, King County, Washington",549,97,261,86,151,71,110,77,288,97,105,75,183,78
1500000US530330107023,530330107023,"Block Group 3, Census Tract 107.02, King County, Washington",511,111,222,102,118,72,104,68,289,92,63,52,226,88
1500000US530330108001,530330108001,"Block Group 1, Census Tract 108, King County, Washington",539,79,102,50,41,35,61,49,437,79,72,43,365,84
1500000US530330108002,530330108002,"Block Group 2, Census Tract 108, King County, Washington",491,91,83,59,26,33,57,54,408,76,80,50,328,73
1500000US530330108003,530330108003,"Block Group 3, Census Tract 108, King County, Washington",754,83,155,78,53,46,102,57,599,87,92,58,507,80
1500000US530330109001,530330109001,"Block Group 1, Census Tract 109, King County, Washington",402,50,51,37,33,33,18,17,351,52,67,36,284,60
1500000US530330109002,530330109002,"Block Group 2, Census Tract 109, King County, Washington",208,45,25,21,19,18,6,9,183,48,30,19,153,49
1500000US530330110011,530330110011,"Block Group 1, Census Tract 110.01, King County, Washington",377,74,124,43,45,29,79,41,253,56,46,38,207,43
1500000US530330110012,530330110012,"Block Group 2, Census Tract 110.01, King County, Washington",506,110,170,79,109,73,61,45,336,86,202,81,134,63
1500000US530330110013,530330110013,"Block Group 3, Census Tract 110.01, King County, Washington",756,93,415,86,196,68,219,81,341,81,56,41,285,86
1500000US530330110021,530330110021,"Block Group 1, Census Tract 110.02, King County, Washington",260,54,40,28,27,24,13,16,220,57,32,30,188,57
1500000US530330110022,530330110022,"Block Group 2, Census Tract 110.02, King County, Washington",657,83,310,87,65,47,245,84,347,60,90,47,257,59
1500000US530330110023,530330110023,"Block Group 3, Census Tract 110.02, King County, Washington",362,75,54,42,0,12,54,42,308,74,68,38,240,72
1500000US530330111011,530330111011,"Block Group 1, Census Tract 111.01, King County, Washington",391,81,157,69,100,61,57,38,234,85,58,41,176,82
1500000US530330111012,530330111012,"Block Group 2, Census Tract 111.01, King County, Washington",625,121,172,97,82,70,90,68,453,102,68,47,385,102
1500000US530330111013,530330111013,"Block Group 3, Census Tract 111.01, King County, Washington",350,91,65,51,48,49,17,20,285,87,14,20,271,85
1500000US530330111014,530330111014,"Block Group 4, Census Tract 111.01, King County, Washington",422,81,97,63,31,31,66,56,325,79,75,52,250,74
1500000US530330111021,530330111021,"Block Group 1, Census Tract 111.02, King County, Washington",420,55,0,12,0,12,0,12,420,55,95,45,325,64
1500000US530330111022,530330111022,"Block Group 2, Census Tract 111.02, King County, Washington",363,95,64,55,64,55,0,12,299,88,70,48,229,82
1500000US530330111023,530330111023,"Block Group 3, Census Tract 111.02, King County, Washington",371,100,81,57,11,17,70,54,290,93,63,46,227,92
1500000US530330111024,530330111024,"Block Group 4, Census Tract 111.02, King County, Washington",307,73,20,24,9,15,11,18,287,73,19,18,268,71
1500000US530330112001,530330112001,"Block Group 1, Census Tract 112, King County, Washington",429,82,68,48,30,38,38,47,361,84,103,52,258,79
1500000US530330112002,530330112002,"Block Group 2, Census Tract 112, King County, Washington",392,85,27,34,9,16,18,29,365,90,113,76,252,74
1500000US530330112003,530330112003,"Block Group 3, Census Tract 112, King County, Washington",591,114,230,125,30,40,200,123,361,98,38,41,323,89
1500000US530330113001,530330113001,"Block Group 1, Census Tract 113, King County, Washington",1307,140,267,116,189,103,78,51,1040,159,352,138,688,151
1500000US530330113002,530330113002,"Block Group 2, Census Tract 113, King County, Washington",420,84,75,66,34,49,41,46,345,80,49,46,296,78
1500000US530330113003,530330113003,"Block Group 3, Census Tract 113, King County, Washington",316,102,54,53,41,50,13,22,262,89,75,57,187,93
1500000US530330113004,530330113004,"Block Group 4, Census Tract 113, King County, Washington",433,78,68,57,0,12,68,57,365,65,90,58,275,80
1500000US530330113005,530330113005,"Block Group 5, Census Tract 113, King County, Washington",518,109,136,103,41,52,95,93,382,93,35,35,347,97
1500000US530330114011,530330114011,"Block Group 1, Census Tract 114.01, King County, Washington",646,117,100,76,21,33,79,67,546,108,72,50,474,100
1500000US530330114012,530330114012,"Block Group 2, Census Tract 114.01, King County, Washington",510,94,24,24,9,15,15,19,486,95,60,41,426,89
1500000US530330114013,530330114013,"Block Group 3, Census Tract 114.01, King County, Washington",550,63,71,40,33,28,38,37,479,75,112,69,367,66
1500000US530330114021,530330114021,"Block Group 1, Census Tract 114.02, King County, Washington",585,71,81,51,54,42,27,23,504,85,87,44,417,86
1500000US530330114022,530330114022,"Block Group 2, Census Tract 114.02, King County, Washington",612,102,186,81,60,39,126,70,426,99,78,59,348,87
1500000US530330114023,530330114023,"Block Group 3, Census Tract 114.02, King County, Washington",748,91,235,71,133,52,102,54,513,83,124,63,389,70
1500000US530330115001,530330115001,"Block Group 1, Census Tract 115, King County, Washington",534,66,30,23,18,19,12,15,504,71,94,40,410,75
1500000US530330115002,530330115002,"Block Group 2, Census Tract 115, King County, Washington",675,69,20,21,9,14,11,16,655,67,96,49,559,75
1500000US530330115003,530330115003,"Block Group 3, Census Tract 115, King County, Washington",767,75,24,23,8,13,16,18,743,78,119,58,624,93
1500000US530330116001,530330116001,"Block Group 1, Census Tract 116, King County, Washington",636,118,0,12,0,12,0,12,636,118,114,71,522,118
1500000US530330116002,530330116002,"Block Group 2, Census Tract 116, King County, Washington",558,112,0,12,0,12,0,12,558,112,29,34,529,116
1500000US530330116003,530330116003,"Block Group 3, Census Tract 116, King County, Washington",557,90,0,12,0,12,0,12,557,90,95,53,462,101
1500000US530330116004,530330116004,"Block Group 4, Census Tract 116, King County, Washington",364,67,0,12,0,12,0,12,364,67,68,52,296,71
1500000US530330116005,530330116005,"Block Group 5, Census Tract 116, King County, Washington",458,78,0,12,0,12,0,12,458,78,12,20,446,82
1500000US530330116006,530330116006,"Block Group 6, Census Tract 116, King County, Washington",522,114,0,12,0,12,0,12,522,114,93,63,429,106
1500000US530330117001,530330117001,"Block Group 1, Census Tract 117, King County, Washington",421,108,147,86,80,62,67,60,274,87,101,54,173,88
1500000US530330117002,530330117002,"Block Group 2, Census Tract 117, King County, Washington",476,85,68,39,40,34,28,33,408,87,142,73,266,91
1500000US530330117003,530330117003,"Block Group 3, Census Tract 117, King County, Washington",494,87,75,72,46,64,29,28,419,86,97,45,322,89
1500000US530330117004,530330117004,"Block Group 4, Census Tract 117, King County, Washington",318,92,62,45,24,28,38,33,256,81,62,42,194,85
1500000US530330118001,530330118001,"Block Group 1, Census Tract 118, King County, Washington",357,113,0,12,0,12,0,12,357,113,55,55,302,105
1500000US530330118002,530330118002,"Block Group 2, Census Tract 118, King County, Washington",281,92,52,54,33,46,19,32,229,86,75,66,154,57
1500000US530330118003,530330118003,"Block Group 3, Census Tract 118, King County, Washington",290,120,19,29,0,12,19,29,271,118,14,22,257,117
1500000US530330118004,530330118004,"Block Group 4, Census Tract 118, King County, Washington",583,154,286,131,58,45,228,125,297,120,109,85,188,104
1500000US530330118005,530330118005,"Block Group 5, Census Tract 118, King County, Washington",504,93,148,84,119,81,29,24,356,116,39,48,317,107
1500000US530330118006,530330118006,"Block Group 6, Census Tract 118, King County, Washington",757,162,395,142,133,82,262,136,362,131,86,78,276,113
1500000US530330119001,530330119001,"Block Group 1, Census Tract 119, King County, Washington",688,131,59,45,39,35,20,30,629,126,111,50,518,130
1500000US530330119002,530330119002,"Block Group 2, Census Tract 119, King County, Washington",486,97,35,44,0,12,35,44,451,97,86,53,365,106
1500000US530330119003,530330119003,"Block Group 3, Census Tract 119, King County, Washington",403,140,66,79,0,12,66,79,337,113,61,44,276,102
1500000US530330119004,530330119004,"Block Group 4, Census Tract 119, King County, Washington",563,125,272,111,129,95,143,107,291,117,55,44,236,121
1500000US530330119005,530330119005,"Block Group 5, Census Tract 119, King County, Washington",460,89,13,25,13,25,0,12,447,93,114,61,333,90
1500000US530330120001,530330120001,"Block Group 1, Census Tract 120, King County, Washington",547,82,105,70,81,63,24,27,442,77,99,65,343,74
1500000US530330120002,530330120002,"Block Group 2, Census Tract 120, King County, Washington",417,64,0,12,0,12,0,12,417,64,43,27,374,65
1500000US530330120003,530330120003,"Block Group 3, Census Tract 120, King County, Washington",526,70,19,21,19,21,0,12,507,73,68,51,439,69
1500000US530330121001,530330121001,"Block Group 1, Census Tract 121, King County, Washington",462,54,0,12,0,12,0,12,462,54,64,38,398,58
1500000US530330121002,530330121002,"Block Group 2, Census Tract 121, King County, Washington",740,63,12,15,0,12,12,15,728,65,176,73,552,71
1500000US530330201001,530330201001,"Block Group 1, Census Tract 201, King County, Washington",488,52,25,24,16,19,9,14,463,55,45,29,418,59
1500000US530330201002,530330201002,"Block Group 2, Census Tract 201, King County, Washington",367,47,12,16,12,16,0,12,355,48,89,47,266,60
1500000US530330201003,530330201003,"Block Group 3, Census Tract 201, King County, Washington",407,45,8,13,0,12,8,13,399,47,85,37,314,62
1500000US530330202001,530330202001,"Block Group 1, Census Tract 202, King County, Washington",384,86,22,34,0,12,22,34,362,84,51,32,311,94
1500000US530330202002,530330202002,"Block Group 2, Census Tract 202, King County, Washington",527,97,23,27,11,18,12,20,504,101,192,77,312,115
1500000US530330202003,530330202003,"Block Group 3, Census Tract 202, King County, Washington",347,71,64,57,33,27,31,51,283,62,43,40,240,66
1500000US530330202004,530330202004,"Block Group 4, Census Tract 202, King County, Washington",421,88,29,36,0,12,29,36,392,92,87,75,305,82
1500000US530330202005,530330202005,"Block Group 5, Census Tract 202, King County, Washington",443,91,0,12,0,12,0,12,443,91,62,55,381,97
1500000US530330203001,530330203001,"Block Group 1, Census Tract 203, King County, Washington",705,139,49,46,29,34,20,35,656,138,97,78,559,129
1500000US530330203002,530330203002,"Block Group 2, Census Tract 203, King County, Washington",390,97,14,22,14,22,0,12,376,101,56,41,320,98
1500000US530330203003,530330203003,"Block Group 3, Census Tract 203, King County, Washington",355,82,26,29,11,17,15,23,329,91,100,52,229,95
1500000US530330203004,530330203004,"Block Group 4, Census Tract 203, King County, Washington",490,103,4,11,0,12,4,11,486,102,66,50,420,99
1500000US530330203005,530330203005,"Block Group 5, Census Tract 203, King County, Washington",1098,170,242,94,121,71,121,68,856,178,161,99,695,171
1500000US530330204011,530330204011,"Block Group 1, Census Tract 204.01, King County, Washington",815,76,106,65,49,39,57,61,709,93,98,50,611,96
1500000US530330204012,530330204012,"Block Group 2, Census Tract 204.01, King County, Washington",346,61,0,12,0,12,0,12,346,61,105,46,241,51
1500000US530330204013,530330204013,"Block Group 3, Census Tract 204.01, King County, Washington",245,47,24,23,17,19,7,12,221,48,41,31,180,46
1500000US530330204021,530330204021,"Block Group 1, Census Tract 204.02, King County, Washington",526,90,26,29,0,12,26,29,500,92,174,104,326,74
1500000US530330204022,530330204022,"Block Group 2, Census Tract 204.02, King County, Washington",423,80,0,12,0,12,0,12,423,80,120,79,303,77
1500000US530330204023,530330204023,"Block Group 3, Census Tract 204.02, King County, Washington",299,96,55,85,0,12,55,85,244,56,40,35,204,61
1500000US530330204024,530330204024,"Block Group 4, Census Tract 204.02, King County, Washington",358,61,0,12,0,12,0,12,358,61,44,39,314,71
1500000US530330204025,530330204025,"Block Group 5, Census Tract 204.02, King County, Washington",569,124,98,58,80,55,18,29,471,129,44,36,427,128
1500000US530330205001,530330205001,"Block Group 1, Census Tract 205, King County, Washington",756,123,123,67,107,61,16,26,633,135,53,47,580,139
1500000US530330205002,530330205002,"Block Group 2, Census Tract 205, King County, Washington",544,121,53,54,38,62,15,24,491,137,91,87,400,112
1500000US530330205003,530330205003,"Block Group 3, Census Tract 205, King County, Washington",422,93,13,23,0,12,13,23,409,95,97,77,312,90
1500000US530330205004,530330205004,"Block Group 4, Census Tract 205, King County, Washington",271,66,10,16,0,12,10,16,261,64,75,49,186,62
1500000US530330205005,530330205005,"Block Group 5, Census Tract 205, King County, Washington",393,97,23,35,23,35,0,12,370,96,51,42,319,107
1500000US530330205006,530330205006,"Block Group 6, Census Tract 205, King County, Washington",318,76,14,23,14,23,0,12,304,77,43,32,261,85
1500000US530330206001,530330206001,"Block Group 1, Census Tract 206, King County, Washington",303,49,22,22,9,14,13,17,281,51,66,39,215,52
1500000US530330206002,530330206002,"Block Group 2, Census Tract 206, King County, Washington",327,76,45,51,36,48,9,15,282,62,40,28,242,62
1500000US530330206003,530330206003,"Block Group 3, Census Tract 206, King County, Washington",315,53,20,25,20,25,0,12,295,50,11,14,284,50
1500000US530330206004,530330206004,"Block Group 4, Census Tract 206, King County, Washington",355,65,7,12,7,12,0,12,348,66,93,65,255,67
1500000US530330207001,530330207001,"Block Group 1, Census Tract 207, King County, Washington",477,71,37,29,9,14,28,25,440,76,73,43,367,77
1500000US530330207002,530330207002,"Block Group 2, Census Tract 207, King County, Washington",569,84,232,70,179,60,53,46,337,88,77,42,260,86
1500000US530330207003,530330207003,"Block Group 3, Census Tract 207, King County, Washington",458,83,30,27,22,24,8,13,428,84,162,73,266,75
1500000US530330208001,530330208001,"Block Group 1, Census Tract 208, King County, Washington",585,84,97,55,45,25,52,52,488,83,101,42,387,91
1500000US530330208002,530330208002,"Block Group 2, Census Tract 208, King County, Washington",526,74,41,29,0,12,41,29,485,78,65,34,420,82
1500000US530330208003,530330208003,"Block Group 3, Census Tract 208, King County, Washington",329,39,16,19,8,13,8,13,313,44,13,14,300,46
1500000US530330208004,530330208004,"Block Group 4, Census Tract 208, King County, Washington",332,47,0,12,0,12,0,12,332,47,51,34,281,50
1500000US530330209001,530330209001,"Block Group 1, Census Tract 209, King County, Washington",662,79,113,66,19,26,94,60,549,82,95,44,454,81
1500000US530330209002,530330209002,"Block Group 2, Census Tract 209, King County, Washington",429,60,57,38,50,37,7,13,372,71,74,41,298,73
1500000US530330209003,530330209003,"Block Group 3, Census Tract 209, King County, Washington",337,67,17,23,5,8,12,22,320,67,36,27,284,71
1500000US530330210001,530330210001,"Block Group 1, Census Tract 210, King County, Washington",330,66,33,29,0,12,33,29,297,64,71,48,226,70
1500000US530330210002,530330210002,"Block Group 2, Census Tract 210, King County, Washington",323,85,0,12,0,12,0,12,323,85,65,45,258,85
1500000US530330210003,530330210003,"Block Group 3, Census Tract 210, King County, Washington",602,122,21,25,21,25,0,12,581,121,88,74,493,124
1500000US530330210004,530330210004,"Block Group 4, Census Tract 210, King County, Washington",461,108,0,12,0,12,0,12,461,108,157,81,304,101
1500000US530330210005,530330210005,"Block Group 5, Census Tract 210, King County, Washington",404,101,50,46,0,12,50,46,354,111,83,53,271,112
1500000US530330211001,530330211001,"Block Group 1, Census Tract 211, King County, Washington",590,73,77,62,43,54,34,34,513,74,73,39,440,76
1500000US530330211002,530330211002,"Block Group 2, Census Tract 211, King County, Washington",499,74,101,64,67,52,34,52,398,71,123,75,275,70
1500000US530330211003,530330211003,"Block Group 3, Census Tract 211, King County, Washington",468,82,146,46,72,36,74,32,322,77,28,27,294,77
1500000US530330211004,530330211004,"Block Group 4, Census Tract 211, King County, Washington",0,12,0,12,0,12,0,12,0,12,0,12,0,12
1500000US530330213001,530330213001,"Block Group 1, Census Tract 213, King County, Washington",716,97,21,24,0,12,21,24,695,96,168,58,527,105
1500000US530330213002,530330213002,"Block Group 2, Census Tract 213, King County, Washington",514,96,32,31,22,27,10,15,482,95,45,35,437,92
1500000US530330213003,530330213003,"Block Group 3, Census Tract 213, King County, Washington",518,77,97,44,52,38,45,30,421,76,32,26,389,75
1500000US530330214001,530330214001,"Block Group 1, Census Tract 214, King County, Washington",330,49,17,20,12,19,5,8,313,51,75,36,238,53
1500000US530330214002,530330214002,"Block Group 2, Census Tract 214, King County, Washington",610,72,47,38,13,20,34,33,563,73,103,45,460,77
1500000US530330214003,530330214003,"Block Group 3, Census Tract 214, King County, Washington",473,74,12,18,12,18,0,12,461,74,62,34,399,75
1500000US530330215001,530330215001,"Block Group 1, Census Tract 215, King County, Washington",338,66,0,12,0,12,0,12,338,66,75,49,263,60
1500000US530330215002,530330215002,"Block Group 2, Census Tract 215, King County, Washington",375,58,0,12,0,12,0,12,375,58,85,33,290,66
1500000US530330215003,530330215003,"Block Group 3, Census Tract 215, King County, Washington",623,64,20,22,12,19,8,12,603,66,100,50,503,66
1500000US530330215004,530330215004,"Block Group 4, Census Tract 215, King County, Washington",410,59,16,18,16,18,0,12,394,62,78,61,316,61
1500000US530330216001,530330216001,"Block Group 1, Census Tract 216, King County, Washington",523,65,29,26,0,12,29,26,494,66,80,37,414,66
1500000US530330216002,530330216002,"Block Group 2, Census Tract 216, King County, Washington",433,73,7,12,0,12,7,12,426,74,99,50,327,73
1500000US530330216003,530330216003,"Block Group 3, Census Tract 216, King County, Washington",493,60,41,28,8,13,33,25,452,66,105,39,347,73
1500000US530330216004,530330216004,"Block Group 4, Census Tract 216, King County, Washington",334,59,31,26,20,21,11,18,303,63,33,26,270,62
1500000US530330217001,530330217001,"Block Group 1, Census Tract 217, King County, Washington",578,108,57,70,16,25,41,66,521,94,100,73,421,95
1500000US530330217002,530330217002,"Block Group 2, Census Tract 217, King County, Washington",702,115,74,76,41,67,33,38,628,100,63,47,565,100
1500000US530330217003,530330217003,"Block Group 3, Census Tract 217, King County, Washington",537,85,14,23,14,23,0,12,523,93,125,66,398,103
1500000US530330217004,530330217004,"Block Group 4, Census Tract 217, King County, Washington",738,132,146,64,74,43,72,51,592,130,156,102,436,125
1500000US530330217005,530330217005,"Block Group 5, Census Tract 217, King County, Washington",893,118,117,53,33,42,84,51,776,124,151,74,625,132
1500000US530330218021,530330218021,"Block Group 1, Census Tract 218.02, King County, Washington",836,114,16,25,0,12,16,25,820,112,149,86,671,117
1500000US530330218022,530330218022,"Block Group 2, Census Tract 218.02, King County, Washington",918,135,76,65,21,23,55,65,842,141,46,43,796,132
1500000US530330218023,530330218023,"Block Group 3, Census Tract 218.02, King County, Washington",501,80,10,17,10,17,0,12,491,81,35,39,456,84
1500000US530330218031,530330218031,"Block Group 1, Census Tract 218.03, King County, Washington",638,96,134,81,42,37,92,76,504,95,64,35,440,98
1500000US530330218032,530330218032,"Block Group 2, Census Tract 218.03, King County, Washington",327,56,33,28,23,24,10,16,294,58,60,37,234,63
1500000US530330218033,530330218033,"Block Group 3, Census Tract 218.03, King County, Washington",610,92,50,51,41,50,9,14,560,91,85,45,475,93
1500000US530330218034,530330218034,"Block Group 4, Census Tract 218.03, King County, Washington",399,52,21,32,0,12,21,32,378,53,83,44,295,61
1500000US530330218041,530330218041,"Block Group 1, Census Tract 218.04, King County, Washington",577,64,0,12,0,12,0,12,577,64,74,44,503,76
1500000US530330218042,530330218042,"Block Group 2, Census Tract 218.04, King County, Washington",703,81,37,30,15,18,22,24,666,82,127,71,539,89
1500000US530330218043,530330218043,"Block Group 3, Census Tract 218.04, King County, Washington",434,77,23,19,23,19,0,12,411,82,80,48,331,79
1500000US530330219031,530330219031,"Block Group 1, Census Tract 219.03, King County, Washington",953,183,26,28,14,23,12,18,927,183,167,83,760,181
1500000US530330219032,530330219032,"Block Group 2, Census Tract 219.03, King County, Washington",401,76,0,12,0,12,0,12,401,76,69,59,332,85
1500000US530330219033,530330219033,"Block Group 3, Census Tract 219.03, King County, Washington",259,71,13,24,13,24,0,12,246,76,35,39,211,76
1500000US530330219034,530330219034,"Block Group 4, Census Tract 219.03, King County, Washington",186,60,32,37,0,12,32,37,154,62,23,36,131,57
1500000US530330219035,530330219035,"Block Group 5, Census Tract 219.03, King County, Washington",605,153,8,16,8,16,0,12,597,157,106,55,491,156
1500000US530330219041,530330219041,"Block Group 1, Census Tract 219.04, King County, Washington",595,81,166,78,133,77,33,27,429,76,16,18,413,72
1500000US530330219042,530330219042,"Block Group 2, Census Tract 219.04, King County, Washington",297,47,6,9,0,12,6,9,291,47,31,20,260,50
1500000US530330219043,530330219043,"Block Group 3, Census Tract 219.04, King County, Washington",520,68,41,44,0,12,41,44,479,72,83,47,396,79
1500000US530330219044,530330219044,"Block Group 4, Census Tract 219.04, King County, Washington",377,71,5,10,0,12,5,10,372,72,53,29,319,75
1500000US530330219051,530330219051,"Block Group 1, Census Tract 219.05, King County, Washington",800,124,14,23,14,23,0,12,786,126,59,49,727,129
1500000US530330219052,530330219052,"Block Group 2, Census Tract 219.05, King County, Washington",428,71,10,21,0,12,10,21,418,74,84,61,334,78
1500000US530330219053,530330219053,"Block Group 3, Census Tract 219.05, King County, Washington",567,138,22,31,17,28,5,22,545,139,81,73,464,130
1500000US530330219054,530330219054,"Block Group 4, Census Tract 219.05, King County, Washington",415,94,31,37,0,12,31,37,384,94,96,80,288,87
1500000US530330219061,530330219061,"Block Group 1, Census Tract 219.06, King County, Washington",681,78,24,20,0,12,24,20,657,78,57,35,600,81
1500000US530330219062,530330219062,"Block Group 2, Census Tract 219.06, King County, Washington",261,66,0,12,0,12,0,12,261,66,27,24,234,66
1500000US530330219063,530330219063,"Block Group 3, Census Tract 219.06, King County, Washington",626,109,54,54,21,17,33,51,572,112,63,40,509,111
1500000US530330220011,530330220011,"Block Group 1, Census Tract 220.01, King County, Washington",431,114,7,14,0,12,7,14,424,117,40,42,384,110
1500000US530330220012,530330220012,"Block Group 2, Census Tract 220.01, King County, Washington",1239,129,65,50,26,31,39,37,1174,133,497,137,677,119
1500000US530330220013,530330220013,"Block Group 3, Census Tract 220.01, King County, Washington",500,84,13,20,0,12,13,20,487,86,61,41,426,91
1500000US530330220031,530330220031,"Block Group 1, Census Tract 220.03, King County, Washington",447,62,14,16,14,16,0,12,433,64,91,41,342,72
1500000US530330220032,530330220032,"Block Group 2, Census Tract 220.03, King County, Washington",439,78,11,18,0,12,11,18,428,80,51,35,377,88
1500000US530330220033,530330220033,"Block Group 3, Census Tract 220.03, King County, Washington",377,65,8,13,8,13,0,12,369,65,81,44,288,72
1500000US530330220034,530330220034,"Block Group 4, Census Tract 220.03, King County, Washington",337,80,0,12,0,12,0,12,337,80,35,30,302,88
1500000US530330220035,530330220035,"Block Group 5, Census Tract 220.03, King County, Washington",351,71,12,20,0,12,12,20,339,73,67,62,272,83
1500000US530330220051,530330220051,"Block Group 1, Census Tract 220.05, King County, Washington",934,126,51,50,18,28,33,41,883,129,111,72,772,138
1500000US530330220052,530330220052,"Block Group 2, Census Tract 220.05, King County, Washington",443,106,21,31,0,12,21,31,422,111,36,45,386,106
1500000US530330220053,530330220053,"Block Group 3, Census Tract 220.05, King County, Washington",852,126,22,36,0,12,22,36,830,127,13,21,817,129
1500000US530330220061,530330220061,"Block Group 1, Census Tract 220.06, King County, Washington",558,71,18,23,18,23,0,12,540,77,94,45,446,73
1500000US530330220062,530330220062,"Block Group 2, Census Tract 220.06, King County, Washington",514,72,12,15,0,12,12,15,502,75,79,41,423,85
1500000US530330220063,530330220063,"Block Group 3, Census Tract 220.06, King County, Washington",647,82,102,63,31,31,71,58,545,86,55,34,490,95
1500000US530330221011,530330221011,"Block Group 1, Census Tract 221.01, King County, Washington",564,83,28,17,0,12,28,17,536,82,120,58,416,84
1500000US530330221012,530330221012,"Block Group 2, Census Tract 221.01, King County, Washington",387,56,8,13,0,12,8,13,379,56,37,29,342,55
1500000US530330221013,530330221013,"Block Group 3, Census Tract 221.01, King County, Washington",596,79,46,52,46,52,0,12,550,74,71,52,479,71
1500000US530330221014,530330221014,"Block Group 4, Census Tract 221.01, King County, Washington",263,46,10,15,0,12,10,15,253,48,58,36,195,50
1500000US530330221021,530330221021,"Block Group 1, Census Tract 221.02, King County, Washington",1130,123,37,40,18,29,19,27,1093,128,134,84,959,147
1500000US530330221022,530330221022,"Block Group 2, Census Tract 221.02, King County, Washington",286,62,17,25,17,25,0,12,269,68,32,35,237,65
1500000US530330221023,530330221023,"Block Group 3, Census Tract 221.02, King County, Washington",351,77,20,31,20,31,0,12,331,74,0,12,331,74
1500000US530330221024,530330221024,"Block Group 4, Census Tract 221.02, King County, Washington",521,65,0,12,0,12,0,12,521,65,68,49,453,67
1500000US530330222011,530330222011,"Block Group 1, Census Tract 222.01, King County, Washington",354,75,35,42,11,17,24,37,319,72,46,28,273,77
1500000US530330222012,530330222012,"Block Group 2, Census Tract 222.01, King County, Washington",273,55,5,10,0,12,5,10,268,56,80,47,188,50
1500000US530330222013,530330222013,"Block Group 3, Census Tract 222.01, King County, Washington",700,78,85,46,10,15,75,43,615,77,75,36,540,81
1500000US530330222014,530330222014,"Block Group 4, Census Tract 222.01, King County, Washington",361,59,8,13,0,12,8,13,353,60,80,45,273,53
1500000US530330222021,530330222021,"Block Group 1, Census Tract 222.02, King County, Washington",493,90,45,35,16,26,29,23,448,89,14,22,434,89
1500000US530330222022,530330222022,"Block Group 2, Census Tract 222.02, King County, Washington",639,131,23,26,12,20,11,18,616,138,45,42,571,144
1500000US530330222023,530330222023,"Block Group 3, Census Tract 222.02, King County, Washington",474,85,17,27,0,12,17,27,457,90,126,69,331,92
1500000US530330222024,530330222024,"Block Group 4, Census Tract 222.02, King County, Washington",465,68,13,21,0,12,13,21,452,72,113,48,339,80
1500000US530330222025,530330222025,"Block Group 5, Census Tract 222.02, King County, Washington",1058,162,55,45,55,45,0,12,1003,159,149,96,854,142
1500000US530330222031,530330222031,"Block Group 1, Census Tract 222.03, King County, Washington",729,75,0,12,0,12,0,12,729,75,69,48,660,83
1500000US530330222032,530330222032,"Block Group 2, Census Tract 222.03, King County, Washington",691,67,0,12,0,12,0,12,691,67,94,51,597,79
1500000US530330222033,530330222033,"Block Group 3, Census Tract 222.03, King County, Washington",466,69,17,19,9,14,8,13,449,71,77,55,372,77
1500000US530330223001,530330223001,"Block Group 1, Census Tract 223, King County, Washington",602,50,10,16,10,16,0,12,592,50,72,54,520,65
1500000US530330223002,530330223002,"Block Group 2, Census Tract 223, King County, Washington",382,53,0,12,0,12,0,12,382,53,19,26,363,55
1500000US530330224001,530330224001,"Block Group 1, Census Tract 224, King County, Washington",823,144,17,25,17,25,0,12,806,148,75,61,731,144
1500000US530330224002,530330224002,"Block Group 2, Census Tract 224, King County, Washington",537,106,15,25,0,12,15,25,522,104,51,45,471,111
1500000US530330224003,530330224003,"Block Group 3, Census Tract 224, King County, Washington",593,120,0,12,0,12,0,12,593,120,28,32,565,118
1500000US530330224004,530330224004,"Block Group 4, Census Tract 224, King County, Washington",913,186,107,66,59,45,48,51,806,186,55,52,751,189
1500000US530330224005,530330224005,"Block Group 5, Census Tract 224, King County, Washington",493,137,0,12,0,12,0,12,493,137,49,41,444,148
1500000US530330224006,530330224006,"Block Group 6, Census Tract 224, King County, Washington",451,92,52,78,0,12,52,78,399,93,43,41,356,98
1500000US530330225001,530330225001,"Block Group 1, Census Tract 225, King County, Washington",523,111,13,22,13,22,0,12,510,113,44,42,466,125
1500000US530330225002,530330225002,"Block Group 2, Census Tract 225, King County, Washington",646,97,14,23,14,23,0,12,632,100,153,95,479,94
1500000US530330225003,530330225003,"Block Group 3, Census Tract 225, King County, Washington",686,136,32,35,17,27,15,24,654,144,71,89,583,135
1500000US530330225004,530330225004,"Block Group 4, Census Tract 225, King County, Washington",982,162,19,31,0,12,19,31,963,164,248,123,715,140
1500000US530330225005,530330225005,"Block Group 5, Census Tract 225, King County, Washington",1126,120,0,12,0,12,0,12,1126,120,143,68,983,125
1500000US530330226031,530330226031,"Block Group 1, Census Tract 226.03, King County, Washington",416,109,0,12,0,12,0,12,416,109,85,92,331,118
1500000US530330226032,530330226032,"Block Group 2, Census Tract 226.03, King County, Washington",264,56,0,12,0,12,0,12,264,56,45,34,219,63
1500000US530330226033,530330226033,"Block Group 3, Census Tract 226.03, King County, Washington",434,103,0,12,0,12,0,12,434,103,51,64,383,93
1500000US530330226034,530330226034,"Block Group 4, Census Tract 226.03, King County, Washington",610,96,90,87,0,12,90,87,520,89,121,61,399,92
1500000US530330226035,530330226035,"Block Group 5, Census Tract 226.03, King County, Washington",564,113,43,49,24,38,19,30,521,118,66,67,455,108
1500000US530330226041,530330226041,"Block Group 1, Census Tract 226.04, King County, Washington",733,84,41,57,0,12,41,57,692,82,74,36,618,80
1500000US530330226042,530330226042,"Block Group 2, Census Tract 226.04, King County, Washington",550,70,43,41,31,36,12,17,507,73,66,32,441,78
1500000US530330226043,530330226043,"Block Group 3, Census Tract 226.04, King County, Washington",481,52,0,12,0,12,0,12,481,52,89,46,392,60
1500000US530330226051,530330226051,"Block Group 1, Census Tract 226.05, King County, Washington",1015,164,119,77,38,44,81,62,896,173,140,114,756,155
1500000US530330226052,530330226052,"Block Group 2, Census Tract 226.05, King County, Washington",693,94,0,12,0,12,0,12,693,94,84,57,609,105
1500000US530330226053,530330226053,"Block Group 3, Census Tract 226.05, King County, Washington",869,181,0,12,0,12,0,12,869,181,134,129,735,177
1500000US530330226061,530330226061,"Block Group 1, Census Tract 226.06, King County, Washington",529,103,0,12,0,12,0,12,529,103,151,73,378,105
1500000US530330226062,530330226062,"Block Group 2, Census Tract 226.06, King County, Washington",677,153,92,99,75,92,17,28,585,146,46,43,539,146
1500000US530330226063,530330226063,"Block Group 3, Census Tract 226.06, King County, Washington",602,117,57,49,24,37,33,34,545,123,101,68,444,125
1500000US530330226064,530330226064,"Block Group 4, Census Tract 226.06, King County, Washington",489,114,20,35,0,12,20,35,469,117,51,60,418,125
1500000US530330227011,530330227011,"Block Group 1, Census Tract 227.01, King County, Washington",850,95,17,19,8,14,9,14,833,99,188,59,645,95
1500000US530330227012,530330227012,"Block Group 2, Census Tract 227.01, King County, Washington",629,82,0,12,0,12,0,12,629,82,58,43,571,83
1500000US530330227021,530330227021,"Block Group 1, Census Tract 227.02, King County, Washington",598,96,0,12,0,12,0,12,598,96,53,37,545,96
1500000US530330227022,530330227022,"Block Group 2, Census Tract 227.02, King County, Washington",402,68,20,27,0,12,20,27,382,70,32,23,350,76
1500000US530330227023,530330227023,"Block Group 3, Census Tract 227.02, King County, Washington",403,61,11,19,11,19,0,12,392,59,28,25,364,61
1500000US530330227031,530330227031,"Block Group 1, Census Tract 227.03, King County, Washington",495,46,23,21,11,15,12,13,472,48,41,20,431,51
1500000US530330227032,530330227032,"Block Group 2, Census Tract 227.03, King County, Washington",344,37,24,22,19,21,5,8,320,36,19,14,301,34
1500000US530330228011,530330228011,"Block Group 1, Census Tract 228.01, King County, Washington",1323,186,17,27,0,12,17,27,1306,187,89,55,1217,191
1500000US530330228012,530330228012,"Block Group 2, Census Tract 228.01, King County, Washington",1224,195,193,105,83,77,110,76,1031,167,159,99,872,169
1500000US530330228013,530330228013,"Block Group 3, Census Tract 228.01, King County, Washington",426,87,0,12,0,12,0,12,426,87,64,54,362,95
1500000US530330228014,530330228014,"Block Group 4, Census Tract 228.01, King County, Washington",797,134,99,82,30,33,69,74,698,127,90,71,608,135
1500000US530330228021,530330228021,"Block Group 1, Census Tract 228.02, King County, Washington",782,88,7,10,7,10,0,12,775,88,47,31,728,89
1500000US530330228022,530330228022,"Block Group 2, Census Tract 228.02, King County, Washington",649,80,40,34,40,34,0,12,609,87,84,46,525,83
1500000US530330228023,530330228023,"Block Group 3, Census Tract 228.02, King County, Washington",609,72,37,44,0,12,37,44,572,64,71,51,501,80
1500000US530330228031,530330228031,"Block Group 1, Census Tract 228.03, King County, Washington",339,87,0,12,0,12,0,12,339,87,50,72,289,100
1500000US530330228032,530330228032,"Block Group 2, Census Tract 228.03, King County, Washington",1013,164,16,26,0,12,16,26,997,160,104,63,893,165
1500000US530330228033,530330228033,"Block Group 3, Census Tract 228.03, King County, Washington",852,150,183,100,76,62,107,105,669,136,146,100,523,128
1500000US530330229011,530330229011,"Block Group 1, Census Tract 229.01, King County, Washington",540,60,21,22,14,19,7,11,519,61,133,48,386,66
1500000US530330229012,530330229012,"Block Group 2, Census Tract 229.01, King County, Washington",462,55,11,17,11,17,0,12,451,58,80,49,371,62
1500000US530330229021,530330229021,"Block Group 1, Census Tract 229.02, King County, Washington",602,102,0,12,0,12,0,12,602,102,85,53,517,103
1500000US530330229022,530330229022,"Block Group 2, Census Tract 229.02, King County, Washington",296,53,0,12,0,12,0,12,296,53,71,47,225,55
1500000US530330229023,530330229023,"Block Group 3, Census Tract 229.02, King County, Washington",314,81,0,12,0,12,0,12,314,81,110,78,204,78
1500000US530330229024,530330229024,"Block Group 4, Census Tract 229.02, King County, Washington",790,127,0,12,0,12,0,12,790,127,72,67,718,140
1500000US530330229025,530330229025,"Block Group 5, Census Tract 229.02, King County, Washington",392,78,0,12,0,12,0,12,392,78,76,56,316,83
1500000US530330230001,530330230001,"Block Group 1, Census Tract 230, King County, Washington",429,56,24,22,5,9,19,20,405,62,97,46,308,57
1500000US530330230002,530330230002,"Block Group 2, Census Tract 230, King County, Washington",462,57,7,11,0,12,7,11,455,59,45,29,410,58
1500000US530330230003,530330230003,"Block Group 3, Census Tract 230, King County, Washington",431,56,14,16,9,14,5,9,417,58,94,49,323,53
1500000US530330230004,530330230004,"Block Group 4, Census Tract 230, King County, Washington",458,71,9,14,9,14,0,12,449,72,57,30,392,69
1500000US530330231001,530330231001,"Block Group 1, Census Tract 231, King County, Washington",390,54,27,26,15,17,12,20,363,59,53,32,310,58
1500000US530330231002,530330231002,"Block Group 2, Census Tract 231, King County, Washington",413,54,23,26,12,19,11,17,390,53,74,46,316,52
1500000US530330231003,530330231003,"Block Group 3, Census Tract 231, King County, Washington",559,69,7,12,7,12,0,12,552,70,113,41,439,74
1500000US530330232011,530330232011,"Block Group 1, Census Tract 232.01, King County, Washington",481,140,36,31,0,12,36,31,445,150,138,72,307,138
1500000US530330232012,530330232012,"Block Group 2, Census Tract 232.01, King County, Washington",941,213,132,88,96,67,36,56,809,199,125,114,684,181
1500000US530330232013,530330232013,"Block Group 3, Census Tract 232.01, King County, Washington",1201,228,48,38,37,31,11,20,1153,226,231,157,922,166
1500000US530330232021,530330232021,"Block Group 1, Census Tract 232.02, King County, Washington",789,129,131,49,66,37,65,44,658,135,200,67,458,125
1500000US530330232022,530330232022,"Block Group 2, Census Tract 232.02, King County, Washington",462,85,10,16,10,16,0,12,452,86,108,54,344,90
1500000US530330232023,530330232023,"Block Group 3, Census Tract 232.02, King County, Washington",556,110,108,71,43,50,65,53,448,103,73,46,375,99
1500000US530330233001,530330233001,"Block Group 1, Census Tract 233, King County, Washington",637,103,8,13,0,12,8,13,629,105,89,53,540,125
1500000US530330233002,530330233002,"Block Group 2, Census Tract 233, King County, Washington",419,115,43,64,0,12,43,64,376,114,127,92,249,107
1500000US530330233003,530330233003,"Block Group 3, Census Tract 233, King County, Washington",643,128,180,133,125,103,55,81,463,109,94,62,369,103
1500000US530330233004,530330233004,"Block Group 4, Census Tract 233, King County, Washington",590,119,85,76,13,22,72,71,505,114,169,83,336,95
1500000US530330234011,530330234011,"Block Group 1, Census Tract 234.01, King County, Washington",428,70,24,31,0,12,24,31,404,67,142,55,262,63
1500000US530330234012,530330234012,"Block Group 2, Census Tract 234.01, King County, Washington",716,72,72,41,48,39,24,22,644,78,105,50,539,88
1500000US530330234013,530330234013,"Block Group 3, Census Tract 234.01, King County, Washington",356,75,66,40,27,34,39,23,290,70,28,25,262,70
1500000US530330234031,530330234031,"Block Group 1, Census Tract 234.03, King County, Washington",617,75,9,13,0,12,9,13,608,74,61,36,547,82
1500000US530330234032,530330234032,"Block Group 2, Census Tract 234.03, King County, Washington",492,70,0,12,0,12,0,12,492,70,46,32,446,78
1500000US530330234033,530330234033,"Block Group 3, Census Tract 234.03, King County, Washington",497,65,9,14,0,12,9,14,488,66,40,32,448,69
1500000US530330234041,530330234041,"Block Group 1, Census Tract 234.04, King County, Washington",720,72,65,42,8,12,57,45,655,78,62,31,593,83
1500000US530330234042,530330234042,"Block Group 2, Census Tract 234.04, King County, Washington",462,59,0,12,0,12,0,12,462,59,41,29,421,61
1500000US530330235001,530330235001,"Block Group 1, Census Tract 235, King County, Washington",420,52,0,12,0,12,0,12,420,52,80,39,340,61
1500000US530330235002,530330235002,"Block Group 2, Census Tract 235, King County, Washington",447,65,0,12,0,12,0,12,447,65,76,40,371,61
1500000US530330235003,530330235003,"Block Group 3, Census Tract 235, King County, Washington",586,73,50,49,0,12,50,49,536,74,75,44,461,78
1500000US530330236011,530330236011,"Block Group 1, Census Tract 236.01, King County, Washington",714,87,49,29,30,24,19,21,665,94,62,50,603,88
1500000US530330236012,530330236012,"Block Group 2, Census Tract 236.01, King County, Washington",651,87,33,42,26,41,7,12,618,94,35,24,583,96
1500000US530330236013,530330236013,"Block Group 3, Census Tract 236.01, King County, Washington",341,72,0,12,0,12,0,12,341,72,30,26,311,73
1500000US530330236031,530330236031,"Block Group 1, Census Tract 236.03, King County, Washington",489,120,9,16,9,16,0,12,480,121,45,45,435,123
1500000US530330236032,530330236032,"Block Group 2, Census Tract 236.03, King County, Washington",895,160,29,33,15,24,14,24,866,159,23,27,843,160
1500000US530330236033,530330236033,"Block Group 3, Census Tract 236.03, King County, Washington",445,97,57,67,57,67,0,12,388,113,71,56,317,114
1500000US530330236034,530330236034,"Block Group 4, Census Tract 236.03, King County, Washington",527,131,131,96,28,29,103,89,396,103,35,43,361,116
1500000US530330236041,530330236041,"Block Group 1, Census Tract 236.04, King County, Washington",1034,156,103,95,0,12,103,95,931,149,135,85,796,148
1500000US530330236042,530330236042,"Block Group 2, Census Tract 236.04, King County, Washington",323,68,65,24,6,13,59,20,258,74,71,50,187,68
1500000US530330236043,530330236043,"Block Group 3, Census Tract 236.04, King County, Washington",801,143,40,33,0,12,40,33,761,146,281,111,480,142
1500000US530330236044,530330236044,"Block Group 4, Census Tract 236.04, King County, Washington",349,93,70,75,16,25,54,71,279,67,55,45,224,66
1500000US530330237001,530330237001,"Block Group 1, Census Tract 237, King County, Washington",289,60,0,12,0,12,0,12,289,60,75,44,214,56
1500000US530330237002,530330237002,"Block Group 2, Census Tract 237, King County, Washington",682,75,0,12,0,12,0,12,682,75,84,40,598,79
1500000US530330237003,530330237003,"Block Group 3, Census Tract 237, King County, Washington",760,82,4,9,0,12,4,9,756,80,37,29,719,87
1500000US530330238011,530330238011,"Block Group 1, Census Tract 238.01, King County, Washington",684,94,31,23,0,12,31,23,653,94,99,43,554,90
1500000US530330238012,530330238012,"Block Group 2, Census Tract 238.01, King County, Washington",530,92,22,27,7,11,15,25,508,98,81,49,427,92
1500000US530330238031,530330238031,"Block Group 1, Census Tract 238.03, King County, Washington",1483,222,26,30,12,20,14,23,1457,221,290,157,1167,173
1500000US530330238032,530330238032,"Block Group 2, Census Tract 238.03, King County, Washington",1330,184,0,12,0,12,0,12,1330,184,193,104,1137,193
1500000US530330238041,530330238041,"Block Group 1, Census Tract 238.04, King County, Washington",882,143,93,40,27,32,66,45,789,139,125,66,664,136
1500000US530330238042,530330238042,"Block Group 2, Census Tract 238.04, King County, Washington",1135,168,0,12,0,12,0,12,1135,168,55,50,1080,163
1500000US530330238043,530330238043,"Block Group 3, Census Tract 238.04, King County, Washington",1982,258,72,91,54,86,18,29,1910,258,90,82,1820,285
1500000US530330239001,530330239001,"Block Group 1, Census Tract 239, King County, Washington",977,143,114,77,14,23,100,88,863,148,205,95,658,155
1500000US530330239002,530330239002,"Block Group 2, Census Tract 239, King County, Washington",571,101,0,12,0,12,0,12,571,101,86,54,485,125
1500000US530330239003,530330239003,"Block Group 3, Census Tract 239, King County, Washington",691,127,0,12,0,12,0,12,691,127,69,43,622,134
1500000US530330239004,530330239004,"Block Group 4, Census Tract 239, King County, Washington",546,96,20,28,20,28,0,12,526,97,66,51,460,99
1500000US530330240001,530330240001,"Block Group 1, Census Tract 240, King County, Washington",755,149,25,39,0,12,25,39,730,147,63,52,667,144
1500000US530330240002,530330240002,"Block Group 2, Census Tract 240, King County, Washington",678,128,0,12,0,12,0,12,678,128,90,67,588,129
1500000US530330240003,530330240003,"Block Group 3, Census Tract 240, King County, Washington",976,146,43,68,0,12,43,68,933,140,104,68,829,139
1500000US530330240004,530330240004,"Block Group 4, Census Tract 240, King County, Washington",941,135,33,38,16,26,17,27,908,129,66,53,842,131
1500000US530330241001,530330241001,"Block Group 1, Census Tract 241, King County, Washington",384,42,0,12,0,12,0,12,384,42,43,17,341,36
1500000US530330241002,530330241002,"Block Group 2, Census Tract 241, King County, Washington",366,34,5,5,3,4,2,3,361,35,68,23,293,34
1500000US530330241003,530330241003,"Block Group 3, Census Tract 241, King County, Washington",542,43,0,12,0,12,0,12,542,43,92,27,450,48
1500000US530330241004,530330241004,"Block Group 4, Census Tract 241, King County, Washington",400,34,0,12,0,12,0,12,400,34,39,20,361,37
1500000US530330242001,530330242001,"Block Group 1, Census Tract 242, King County, Washington",495,56,0,12,0,12,0,12,495,56,79,46,416,55
1500000US530330242002,530330242002,"Block Group 2, Census Tract 242, King County, Washington",642,62,22,33,0,12,22,33,620,59,55,32,565,59
1500000US530330243001,530330243001,"Block Group 1, Census Tract 243, King County, Washington",582,99,0,12,0,12,0,12,582,99,66,53,516,107
1500000US530330243002,530330243002,"Block Group 2, Census Tract 243, King County, Washington",1359,188,73,73,19,30,54,64,1286,192,351,147,935,165
1500000US530330243003,530330243003,"Block Group 3, Census Tract 243, King County, Washington",489,125,66,79,0,12,66,79,423,119,48,47,375,114
1500000US530330243004,530330243004,"Block Group 4, Census Tract 243, King County, Washington",999,145,103,52,88,60,15,23,896,141,225,130,671,168
1500000US530330243005,530330243005,"Block Group 5, Census Tract 243, King County, Washington",432,80,16,25,0,12,16,25,416,84,33,35,383,88
1500000US530330244001,530330244001,"Block Group 1, Census Tract 244, King County, Washington",560,78,26,34,0,12,26,34,534,79,246,71,288,66
1500000US530330244002,530330244002,"Block Group 2, Census Tract 244, King County, Washington",715,87,52,56,10,15,42,54,663,84,68,57,595,89
1500000US530330245001,530330245001,"Block Group 1, Census Tract 245, King County, Washington",810,76,27,38,27,38,0,12,783,73,71,40,712,76
1500000US530330245002,530330245002,"Block Group 2, Census Tract 245, King County, Washington",492,69,17,19,8,12,9,15,475,70,47,30,428,74
1500000US530330245003,530330245003,"Block Group 3, Census Tract 245, King County, Washington",440,57,8,12,8,12,0,12,432,57,105,53,327,51
1500000US530330246011,530330246011,"Block Group 1, Census Tract 246.01, King County, Washington",607,75,9,14,9,14,0,12,598,76,158,59,440,81
1500000US530330246012,530330246012,"Block Group 2, Census Tract 246.01, King County, Washington",508,67,0,12,0,12,0,12,508,67,94,48,414,73
1500000US530330246013,530330246013,"Block Group 3, Census Tract 246.01, King County, Washington",544,53,0,12,0,12,0,12,544,53,56,35,488,57
1500000US530330246021,530330246021,"Block Group 1, Census Tract 246.02, King County, Washington",327,58,12,16,0,12,12,16,315,57,27,21,288,57
1500000US530330246022,530330246022,"Block Group 2, Census Tract 246.02, King County, Washington",703,76,0,12,0,12,0,12,703,76,70,36,633,75
1500000US530330246023,530330246023,"Block Group 3, Census Tract 246.02, King County, Washington",253,50,0,12,0,12,0,12,253,50,34,29,219,53
1500000US530330247011,530330247011,"Block Group 1, Census Tract 247.01, King County, Washington",470,74,23,22,0,12,23,22,447,79,65,35,382,84
1500000US530330247012,530330247012,"Block Group 2, Census Tract 247.01, King County, Washington",554,105,80,69,12,18,68,70,474,85,73,50,401,91
1500000US530330247013,530330247013,"Block Group 3, Census Tract 247.01, King County, Washington",382,80,19,22,10,17,9,15,363,79,42,26,321,83
1500000US530330247021,530330247021,"Block Group 1, Census Tract 247.02, King County, Washington",751,138,0,12,0,12,0,12,751,138,117,61,634,145
1500000US530330247022,530330247022,"Block Group 2, Census Tract 247.02, King County, Washington",493,88,0,12,0,12,0,12,493,88,117,70,376,98
1500000US530330247023,530330247023,"Block Group 3, Census Tract 247.02, King County, Washington",639,95,0,12,0,12,0,12,639,95,102,63,537,98
1500000US530330247024,530330247024,"Block Group 4, Census Tract 247.02, King County, Washington",571,94,9,16,9,16,0,12,562,94,96,67,466,94
1500000US530330247025,530330247025,"Block Group 5, Census Tract 247.02, King County, Washington",507,127,0,12,0,12,0,12,507,127,45,43,462,128
1500000US530330248001,530330248001,"Block Group 1, Census Tract 248, King County, Washington",373,70,28,22,28,22,0,12,345,69,33,28,312,65
1500000US530330248002,530330248002,"Block Group 2, Census Tract 248, King County, Washington",736,109,24,31,24,31,0,12,712,108,225,110,487,113
1500000US530330248003,530330248003,"Block Group 3, Census Tract 248, King County, Washington",1066,142,90,79,24,27,66,72,976,142,129,92,847,156
1500000US530330249011,530330249011,"Block Group 1, Census Tract 249.01, King County, Washington",377,57,17,19,10,16,7,11,360,59,139,76,221,45
1500000US530330249012,530330249012,"Block Group 2, Census Tract 249.01, King County, Washington",640,67,0,12,0,12,0,12,640,67,136,51,504,83
1500000US530330249013,530330249013,"Block Group 3, Census Tract 249.01, King County, Washington",374,42,7,11,7,11,0,12,367,43,48,29,319,49
1500000US530330249014,530330249014,"Block Group 4, Census Tract 249.01, King County, Washington",414,64,0,12,0,12,0,12,414,64,57,36,357,62
1500000US530330249021,530330249021,"Block Group 1, Census Tract 249.02, King County, Washington",399,54,0,12,0,12,0,12,399,54,46,30,353,57
1500000US530330249022,530330249022,"Block Group 2, Census Tract 249.02, King County, Washington",548,71,8,13,8,13,0,12,540,74,41,31,499,77
1500000US530330249023,530330249023,"Block Group 3, Census Tract 249.02, King County, Washington",411,62,0,12,0,12,0,12,411,62,91,52,320,59
1500000US530330249031,530330249031,"Block Group 1, Census Tract 249.03, King County, Washington",653,73,13,20,13,20,0,12,640,75,49,46,591,86
1500000US530330249032,530330249032,"Block Group 2, Census Tract 249.03, King County, Washington",619,74,18,28,18,28,0,12,601,73,71,49,530,85
1500000US530330249033,530330249033,"Block Group 3, Census Tract 249.03, King County, Washington",447,68,0,12,0,12,0,12,447,68,13,21,434,72
1500000US530330249034,530330249034,"Block Group 4, Census Tract 249.03, King County, Washington",521,70,13,21,0,12,13,21,508,80,33,35,475,81
1500000US530330250011,530330250011,"Block Group 1, Census Tract 250.01, King County, Washington",350,54,0,12,0,12,0,12,350,54,50,49,300,52
1500000US530330250012,530330250012,"Block Group 2, Census Tract 250.01, King County, Washington",673,97,21,22,12,18,9,14,652,98,20,23,632,97
1500000US530330250013,530330250013,"Block Group 3, Census Tract 250.01, King County, Washington",430,57,37,27,9,14,28,26,393,59,88,51,305,54
1500000US530330250014,530330250014,"Block Group 4, Census Tract 250.01, King County, Washington",387,63,19,22,0,12,19,22,368,71,26,23,342,73
1500000US530330250031,530330250031,"Block Group 1, Census Tract 250.03, King County, Washington",375,82,0,12,0,12,0,12,375,82,41,36,334,72
1500000US530330250032,530330250032,"Block Group 2, Census Tract 250.03, King County, Washington",374,95,43,66,0,12,43,66,331,80,0,12,331,80
1500000US530330250033,530330250033,"Block Group 3, Census Tract 250.03, King County, Washington",546,98,27,28,15,23,12,19,519,101,64,44,455,98
1500000US530330250034,530330250034,"Block Group 4, Census Tract 250.03, King County, Washington",522,108,18,30,0,12,18,30,504,112,58,47,446,121
1500000US530330250035,530330250035,"Block Group 5, Census Tract 250.03, King County, Washington",769,139,0,12,0,12,0,12,769,139,92,76,677,142
1500000US530330250051,530330250051,"Block Group 1, Census Tract 250.05, King County, Washington",974,91,10,14,0,12,10,14,964,87,76,38,888,90
1500000US530330250052,530330250052,"Block Group 2, Census Tract 250.05, King County, Washington",960,103,69,55,38,46,31,30,891,100,116,57,775,102
1500000US530330250061,530330250061,"Block Group 1, Census Tract 250.06, King County, Washington",467,125,20,32,0,12,20,32,447,127,13,20,434,129
1500000US530330250062,530330250062,"Block Group 2, Census Tract 250.06, King County, Washington",1212,127,115,103,49,76,66,75,1097,136,244,97,853,140
1500000US530330250063,530330250063,"Block Group 3, Census Tract 250.06, King County, Washington",549,90,0,12,0,12,0,12,549,90,45,37,504,103
1500000US530330251011,530330251011,"Block Group 1, Census Tract 251.01, King County, Washington",603,119,161,101,101,81,60,72,442,124,28,23,414,121
1500000US530330251012,530330251012,"Block Group 2, Census Tract 251.01, King County, Washington",533,124,0,12,0,12,0,12,533,124,76,57,457,126
1500000US530330251013,530330251013,"Block Group 3, Census Tract 251.01, King County, Washington",325,77,0,12,0,12,0,12,325,77,45,43,280,79
1500000US530330251014,530330251014,"Block Group 4, Census Tract 251.01, King County, Washington",652,100,85,83,0,12,85,83,567,95,55,46,512,104
1500000US530330251021,530330251021,"Block Group 1, Census Tract 251.02, King County, Washington",393,97,31,35,0,12,31,35,362,106,44,39,318,103
1500000US530330251022,530330251022,"Block Group 2, Census Tract 251.02, King County, Washington",581,172,140,126,78,104,62,82,441,128,112,98,329,88
1500000US530330251023,530330251023,"Block Group 3, Census Tract 251.02, King County, Washington",1134,157,17,24,17,24,0,12,1117,164,211,118,906,153
1500000US530330251024,530330251024,"Block Group 4, Census Tract 251.02, King County, Washington",643,139,0,12,0,12,0,12,643,139,157,114,486,123
1500000US530330252001,530330252001,"Block Group 1, Census Tract 252, King County, Washington",458,103,18,29,0,12,18,29,440,97,89,54,351,98
1500000US530330252002,530330252002,"Block Group 2, Census Tract 252, King County, Washington",1010,127,117,76,90,68,27,30,893,133,132,70,761,130
1500000US530330252003,530330252003,"Block Group 3, Census Tract 252, King County, Washington",481,132,141,108,29,32,112,103,340,110,45,34,295,107
1500000US530330252004,530330252004,"Block Group 4, Census Tract 252, King County, Washington",822,115,199,76,58,45,141,76,623,115,127,63,496,110
1500000US530330252005,530330252005,"Block Group 5, Census Tract 252, King County, Washington",482,89,37,38,16,25,21,29,445,84,78,53,367,94
1500000US530330253011,530330253011,"Block Group 1, Census Tract 253.01, King County, Washington",702,138,13,21,0,12,13,21,689,139,87,50,602,141
1500000US530330253012,530330253012,"Block Group 2, Census Tract 253.01, King County, Washington",800,144,31,36,0,12,31,36,769,145,91,65,678,142
1500000US530330253013,530330253013,"Block Group 3, Census Tract 253.01, King County, Washington",1343,221,110,65,28,31,82,64,1233,231,92,71,1141,215
1500000US530330253021,530330253021,"Block Group 1, Census Tract 253.02, King County, Washington",1089,151,96,62,88,63,8,16,993,152,139,68,854,169
1500000US530330253022,530330253022,"Block Group 2, Census Tract 253.02, King County, Washington",833,160,136,111,89,97,47,51,697,143,156,98,541,132
1500000US530330253023,530330253023,"Block Group 3, Census Tract 253.02, King County, Washington",704,168,201,115,59,66,142,89,503,168,92,96,411,144
1500000US530330254001,530330254001,"Block Group 1, Census Tract 254, King County, Washington",575,149,158,107,104,76,54,67,417,134,109,73,308,138
1500000US530330254002,530330254002,"Block Group 2, Census Tract 254, King County, Washington",951,188,356,135,76,87,280,152,595,162,47,76,548,156
1500000US530330254003,530330254003,"Block Group 3, Census Tract 254, King County, Washington",1115,203,243,130,59,44,184,122,872,181,203,69,669,180
1500000US530330254004,530330254004,"Block Group 4, Census Tract 254, King County, Washington",435,116,68,47,12,19,56,48,367,119,38,27,329,123
1500000US530330255001,530330255001,"Block Group 1, Census Tract 255, King County, Washington",1002,106,150,70,64,49,86,52,852,110,111,70,741,108
1500000US530330255002,530330255002,"Block Group 2, Census Tract 255, King County, Washington",534,95,32,23,0,12,32,23,502,95,149,66,353,82
1500000US530330255003,530330255003,"Block Group 3, Census Tract 255, King County, Washington",459,89,54,35,26,26,28,28,405,88,93,51,312,83
1500000US530330256011,530330256011,"Block Group 1, Census Tract 256.01, King County, Washington",369,59,20,21,0,12,20,21,349,61,56,40,293,62
1500000US530330256012,530330256012,"Block Group 2, Census Tract 256.01, King County, Washington",973,93,118,81,96,77,22,25,855,108,138,75,717,122
1500000US530330256013,530330256013,"Block Group 3, Census Tract 256.01, King County, Washington",665,72,63,46,5,11,58,46,602,78,77,54,525,82
1500000US530330256021,530330256021,"Block Group 1, Census Tract 256.02, King County, Washington",740,86,42,37,9,15,33,33,698,85,160,83,538,90
1500000US530330256022,530330256022,"Block Group 2, Census Tract 256.02, King County, Washington",365,73,22,28,22,28,0,12,343,72,79,47,264,75
1500000US530330256023,530330256023,"Block Group 3, Census Tract 256.02, King County, Washington",939,94,50,38,13,24,37,29,889,103,211,73,678,116
1500000US530330257011,530330257011,"Block Group 1, Census Tract 257.01, King County, Washington",560,135,41,43,23,40,18,25,519,145,59,42,460,153
1500000US530330257012,530330257012,"Block Group 2, Census Tract 257.01, King County, Washington",469,123,34,39,34,39,0,12,435,122,128,65,307,116
1500000US530330257013,530330257013,"Block Group 3, Census Tract 257.01, King County, Washington",331,102,181,83,72,44,109,72,150,86,62,61,88,57
1500000US530330257014,530330257014,"Block Group 4, Census Tract 257.01, King County, Washington",664,132,32,36,0,12,32,36,632,135,67,54,565,145
1500000US530330257015,530330257015,"Block Group 5, Census Tract 257.01, King County, Washington",731,153,105,81,30,34,75,82,626,144,176,80,450,131
1500000US530330257021,530330257021,"Block Group 1, Census Tract 257.02, King County, Washington",533,82,0,12,0,12,0,12,533,82,109,54,424,80
1500000US530330257022,530330257022,"Block Group 2, Census Tract 257.02, King County, Washington",348,59,4,9,0,12,4,9,344,60,91,41,253,61
1500000US530330257023,530330257023,"Block Group 3, Census Tract 257.02, King County, Washington",363,59,65,39,41,38,24,29,298,56,82,41,216,71
1500000US530330258031,530330258031,"Block Group 1, Census Tract 258.03, King County, Washington",525,74,63,48,0,12,63,48,462,71,80,42,382,70
1500000US530330258032,530330258032,"Block Group 2, Census Tract 258.03, King County, Washington",630,88,30,27,7,12,23,23,600,88,182,77,418,86
1500000US530330258033,530330258033,"Block Group 3, Census Tract 258.03, King County, Washington",631,100,242,93,141,70,101,66,389,103,16,19,373,103
1500000US530330258041,530330258041,"Block Group 1, Census Tract 258.04, King County, Washington",417,62,45,31,11,17,34,30,372,72,122,50,250,71
1500000US530330258042,530330258042,"Block Group 2, Census Tract 258.04, King County, Washington",302,51,19,19,13,14,6,13,283,52,69,30,214,52
1500000US530330258043,530330258043,"Block Group 3, Census Tract 258.04, King County, Washington",448,77,72,56,23,19,49,53,376,80,69,45,307,75
1500000US530330258051,530330258051,"Block Group 1, Census Tract 258.05, King County, Washington",906,112,113,80,43,48,70,68,793,119,147,84,646,115
1500000US530330258052,530330258052,"Block Group 2, Census Tract 258.05, King County, Washington",370,101,0,12,0,12,0,12,370,101,46,32,324,106
1500000US530330258053,530330258053,"Block Group 3, Census Tract 258.05, King County, Washington",619,89,75,47,57,46,18,20,544,79,161,66,383,75
1500000US530330258061,530330258061,"Block Group 1, Census Tract 258.06, King County, Washington",426,57,13,15,6,10,7,11,413,58,121,44,292,53
1500000US530330258062,530330258062,"Block Group 2, Census Tract 258.06, King County, Washington",821,100,67,50,28,24,39,46,754,102,56,35,698,97
1500000US530330258063,530330258063,"Block Group 3, Census Tract 258.06, King County, Washington",481,86,123,68,64,52,59,49,358,70,93,39,265,69
1500000US530330260011,530330260011,"Block Group 1, Census Tract 260.01, King County, Washington",512,106,45,41,0,12,45,41,467,103,86,46,381,108
1500000US530330260012,530330260012,"Block Group 2, Census Tract 260.01, King County, Washington",349,68,18,20,18,20,0,12,331,71,114,53,217,67
1500000US530330260013,530330260013,"Block Group 3, Census Tract 260.01, King County, Washington",441,99,10,15,10,15,0,12,431,100,99,45,332,104
1500000US530330260014,530330260014,"Block Group 4, Census Tract 260.01, King County, Washington",337,80,69,44,52,37,17,25,268,75,62,36,206,82
1500000US530330260015,530330260015,"Block Group 5, Census Tract 260.01, King County, Washington",402,101,106,71,66,57,40,38,296,87,83,51,213,80
1500000US530330260021,530330260021,"Block Group 1, Census Tract 260.02, King County, Washington",1013,166,237,133,104,82,133,110,776,165,154,107,622,148
1500000US530330260022,530330260022,"Block Group 2, Census Tract 260.02, King County, Washington",711,163,143,94,90,102,53,68,568,150,226,98,342,133
1500000US530330260023,530330260023,"Block Group 3, Census Tract 260.02, King County, Washington",623,137,110,94,17,27,93,92,513,132,50,39,463,135
1500000US530330260024,530330260024,"Block Group 4, Census Tract 260.02, King County, Washington",692,162,32,41,32,41,0,12,660,153,183,116,477,131
1500000US530330261001,530330261001,"Block Group 1, Census Tract 261, King County, Washington",350,95,88,56,63,54,25,31,262,107,77,64,185,97
1500000US530330261002,530330261002,"Block Group 2, Census Tract 261, King County, Washington",550,138,125,85,83,84,42,50,425,140,67,70,358,135
1500000US530330261003,530330261003,"Block Group 3, Census Tract 261, King County, Washington",572,166,148,120,148,120,0,12,424,141,85,112,339,92
1500000US530330261004,530330261004,"Block Group 4, Census Tract 261, King County, Washington",598,125,197,78,74,73,123,82,401,124,32,32,369,127
1500000US530330261005,530330261005,"Block Group 5, Census Tract 261, King County, Washington",524,174,62,58,62,58,0,12,462,185,181,134,281,149
1500000US530330262001,530330262001,"Block Group 1, Census Tract 262, King County, Washington",73,63,39,59,39,59,0,12,34,25,20,22,14,23
1500000US530330262002,530330262002,"Block Group 2, Census Tract 262, King County, Washington",613,126,107,94,22,27,85,89,506,130,82,79,424,133
1500000US530330262003,530330262003,"Block Group 3, Census Tract 262, King County, Washington",951,144,290,142,73,78,217,133,661,193,74,62,587,186
1500000US530330262004,530330262004,"Block Group 4, Census Tract 262, King County, Washington",677,108,86,47,56,57,30,34,591,114,47,38,544,113
1500000US530330263001,530330263001,"Block Group 1, Census Tract 263, King County, Washington",209,48,18,18,6,10,12,16,191,49,58,36,133,46
1500000US530330263002,530330263002,"Block Group 2, Census Tract 263, King County, Washington",358,52,60,39,29,28,31,25,298,65,57,30,241,62
1500000US530330264001,530330264001,"Block Group 1, Census Tract 264, King County, Washington",321,129,92,83,78,82,14,23,229,124,16,25,213,127
1500000US530330264002,530330264002,"Block Group 2, Census Tract 264, King County, Washington",600,147,176,112,60,73,116,93,424,120,35,55,389,111
1500000US530330264003,530330264003,"Block Group 3, Census Tract 264, King County, Washington",479,128,51,37,21,28,30,35,428,122,45,41,383,124
1500000US530330264004,530330264004,"Block Group 4, Census Tract 264, King County, Washington",524,129,15,23,0,12,15,23,509,133,83,54,426,139
1500000US530330264005,530330264005,"Block Group 5, Census Tract 264, King County, Washington",523,144,194,112,92,84,102,117,329,133,75,71,254,127
1500000US530330265001,530330265001,"Block Group 1, Census Tract 265, King County, Washington",338,66,217,76,60,52,157,65,121,50,42,43,79,44
1500000US530330265002,530330265002,"Block Group 2, Census Tract 265, King County, Washington",593,113,392,100,152,84,240,92,201,81,46,34,155,77
1500000US530330265003,530330265003,"Block Group 3, Census Tract 265, King County, Washington",518,112,141,74,53,51,88,53,377,110,100,61,277,93
1500000US530330266001,530330266001,"Block Group 1, Census Tract 266, King County, Washington",426,61,103,61,36,25,67,57,323,61,55,30,268,59
1500000US530330266002,530330266002,"Block Group 2, Census Tract 266, King County, Washington",446,68,38,31,18,16,20,27,408,66,41,21,367,69
1500000US530330267001,530330267001,"Block Group 1, Census Tract 267, King County, Washington",380,98,48,56,20,31,28,48,332,98,140,69,192,93
1500000US530330267002,530330267002,"Block Group 2, Census Tract 267, King County, Washington",654,131,169,86,80,61,89,70,485,154,49,52,436,153
1500000US530330267003,530330267003,"Block Group 3, Census Tract 267, King County, Washington",503,90,0,12,0,12,0,12,503,90,118,63,385,99
1500000US530330267004,530330267004,"Block Group 4, Census Tract 267, King County, Washington",425,86,0,12,0,12,0,12,425,86,42,47,383,89
1500000US530330268011,530330268011,"Block Group 1, Census Tract 268.01, King County, Washington",407,115,27,35,0,12,27,35,380,113,210,88,170,107
1500000US530330268012,530330268012,"Block Group 2, Census Tract 268.01, King County, Washington",570,152,127,104,42,38,85,97,443,145,62,44,381,145
1500000US530330268013,530330268013,"Block Group 3, Census Tract 268.01, King County, Washington",469,133,230,113,101,75,129,97,239,101,52,63,187,90
1500000US530330268014,530330268014,"Block Group 4, Census Tract 268.01, King County, Washington",549,148,253,155,164,128,89,95,296,112,28,34,268,108
1500000US530330268021,530330268021,"Block Group 1, Census Tract 268.02, King County, Washington",452,103,217,89,110,65,107,74,235,87,60,50,175,77
1500000US530330268022,530330268022,"Block Group 2, Census Tract 268.02, King County, Washington",232,61,65,51,28,27,37,44,167,57,38,26,129,53
1500000US530330268023,530330268023,"Block Group 3, Census Tract 268.02, King County, Washington",585,114,137,74,53,46,84,71,448,105,100,74,348,98
1500000US530330268024,530330268024,"Block Group 4, Census Tract 268.02, King County, Washington",381,71,63,51,0,12,63,51,318,70,83,40,235,72
1500000US530330270001,530330270001,"Block Group 1, Census Tract 270, King County, Washington",393,71,113,57,99,57,14,16,280,68,43,32,237,71
1500000US530330270002,530330270002,"Block Group 2, Census Tract 270, King County, Washington",273,52,31,26,26,25,5,9,242,54,60,32,182,53
1500000US530330270003,530330270003,"Block Group 3, Census Tract 270, King County, Washington",480,72,89,54,26,24,63,55,391,77,120,54,271,77
1500000US530330271001,530330271001,"Block Group 1, Census Tract 271, King County, Washington",501,104,120,70,93,67,27,25,381,106,92,57,289,103
1500000US530330271002,530330271002,"Block Group 2, Census Tract 271, King County, Washington",694,133,108,51,59,34,49,37,586,125,105,75,481,117
1500000US530330272001,530330272001,"Block Group 1, Census Tract 272, King County, Washington",355,59,68,38,51,35,17,19,287,54,28,20,259,53
1500000US530330272002,530330272002,"Block Group 2, Census Tract 272, King County, Washington",508,64,229,65,87,48,142,57,279,72,61,37,218,66
1500000US530330273001,530330273001,"Block Group 1, Census Tract 273, King County, Washington",402,74,54,41,39,38,15,16,348,77,83,49,265,64
1500000US530330273002,530330273002,"Block Group 2, Census Tract 273, King County, Washington",681,108,399,91,139,71,260,78,282,82,21,16,261,81
1500000US530330273003,530330273003,"Block Group 3, Census Tract 273, King County, Washington",332,78,90,58,51,49,39,38,242,70,75,42,167,63
1500000US530330273004,530330273004,"Block Group 4, Census Tract 273, King County, Washington",475,90,88,54,42,44,46,26,387,81,142,49,245,71
1500000US530330274001,530330274001,"Block Group 1, Census Tract 274, King County, Washington",530,100,116,82,97,78,19,23,414,87,99,49,315,87
1500000US530330274002,530330274002,"Block Group 2, Census Tract 274, King County, Washington",327,96,0,12,0,12,0,12,327,96,77,39,250,94
1500000US530330274003,530330274003,"Block Group 3, Census Tract 274, King County, Washington",580,90,56,38,46,33,10,19,524,95,145,65,379,88
1500000US530330274004,530330274004,"Block Group 4, Census Tract 274, King County, Washington",289,79,47,29,19,16,28,26,242,76,51,35,191,77
1500000US530330275001,530330275001,"Block Group 1, Census Tract 275, King County, Washington",588,84,155,66,70,56,85,46,433,89,171,78,262,66
1500000US530330275002,530330275002,"Block Group 2, Census Tract 275, King County, Washington",360,66,84,65,62,54,22,32,276,58,85,38,191,61
1500000US530330275003,530330275003,"Block Group 3, Census Tract 275, King County, Washington",395,72,98,67,70,60,28,43,297,61,32,25,265,65
1500000US530330275004,530330275004,"Block Group 4, Census Tract 275, King County, Washington",376,80,22,21,13,17,9,14,354,82,41,26,313,80
1500000US530330276001,530330276001,"Block Group 1, Census Tract 276, King County, Washington",464,100,113,64,41,37,72,47,351,95,54,49,297,86
1500000US530330276002,530330276002,"Block Group 2, Census Tract 276, King County, Washington",826,118,266,88,96,59,170,84,560,115,90,43,470,114
1500000US530330276003,530330276003,"Block Group 3, Census Tract 276, King County, Washington",373,72,0,12,0,12,0,12,373,72,48,35,325,71
1500000US530330277011,530330277011,"Block Group 1, Census Tract 277.01, King County, Washington",603,171,0,12,0,12,0,12,603,171,194,135,409,137
1500000US530330277012,530330277012,"Block Group 2, Census Tract 277.01, King County, Washington",302,82,0,12,0,12,0,12,302,82,12,19,290,86
1500000US530330277013,530330277013,"Block Group 3, Census Tract 277.01, King County, Washington",394,140,14,16,14,16,0,12,380,137,98,110,282,87
1500000US530330277014,530330277014,"Block Group 4, Census Tract 277.01, King County, Washington",628,168,0,12,0,12,0,12,628,168,248,162,380,96
1500000US530330277015,530330277015,"Block Group 5, Census Tract 277.01, King County, Washington",504,162,85,113,0,12,85,113,419,123,104,57,315,127
1500000US530330277021,530330277021,"Block Group 1, Census Tract 277.02, King County, Washington",374,107,16,23,16,23,0,12,358,104,113,66,245,105
1500000US530330277022,530330277022,"Block Group 2, Census Tract 277.02, King County, Washington",563,137,14,23,14,23,0,12,549,139,154,95,395,131
1500000US530330277023,530330277023,"Block Group 3, Census Tract 277.02, King County, Washington",617,153,15,30,0,12,15,30,602,152,165,113,437,128
1500000US530330277024,530330277024,"Block Group 4, Census Tract 277.02, King County, Washington",650,138,0,12,0,12,0,12,650,138,173,93,477,131
1500000US530330278001,530330278001,"Block Group 1, Census Tract 278, King County, Washington",447,58,59,45,33,24,26,40,388,64,89,36,299,69
1500000US530330278002,530330278002,"Block Group 2, Census Tract 278, King County, Washington",440,72,7,11,7,11,0,12,433,72,107,44,326,72
1500000US530330278003,530330278003,"Block Group 3, Census Tract 278, King County, Washington",507,75,32,39,32,39,0,12,475,73,122,47,353,64
1500000US530330279001,530330279001,"Block Group 1, Census Tract 279, King County, Washington",451,133,100,73,73,61,27,43,351,122,74,54,277,114
1500000US530330279002,530330279002,"Block Group 2, Census Tract 279, King County, Washington",810,139,130,69,50,40,80,59,680,155,152,99,528,156
1500000US530330279003,530330279003,"Block Group 3, Census Tract 279, King County, Washington",545,162,98,103,28,42,70,95,447,151,71,65,376,148
1500000US530330279004,530330279004,"Block Group 4, Census Tract 279, King County, Washington",412,121,25,29,9,14,16,26,387,121,51,39,336,119
1500000US530330279005,530330279005,"Block Group 5, Census Tract 279, King County, Washington",361,97,121,101,93,100,28,44,240,80,94,54,146,60
1500000US530330279006,530330279006,"Block Group 6, Census Tract 279, King County, Washington",540,110,57,62,48,59,9,16,483,106,60,40,423,111
1500000US530330280001,530330280001,"Block Group 1, Census Tract 280, King County, Washington",518,96,107,53,40,17,67,49,411,102,42,28,369,101
1500000US530330280002,530330280002,"Block Group 2, Census Tract 280, King County, Washington",547,95,110,62,46,38,64,50,437,102,33,24,404,99
1500000US530330280003,530330280003,"Block Group 3, Census Tract 280, King County, Washington",482,93,149,71,107,64,42,36,333,88,97,44,236,87
1500000US530330281001,530330281001,"Block Group 1, Census Tract 281, King County, Washington",430,66,167,58,77,37,90,50,263,68,63,27,200,72
1500000US530330281002,530330281002,"Block Group 2, Census Tract 281, King County, Washington",393,73,89,55,49,43,40,32,304,69,74,35,230,64
1500000US530330282001,530330282001,"Block Group 1, Census Tract 282, King County, Washington",743,136,255,115,121,80,134,93,488,124,107,69,381,109
1500000US530330282002,530330282002,"Block Group 2, Census Tract 282, King County, Washington",668,109,109,73,99,72,10,17,559,103,67,39,492,104
1500000US530330282003,530330282003,"Block Group 3, Census Tract 282, King County, Washington",486,121,118,70,24,19,94,67,368,125,70,58,298,113
1500000US530330283001,530330283001,"Block Group 1, Census Tract 283, King County, Washington",460,60,35,27,27,24,8,13,425,61,103,44,322,63
1500000US530330283002,530330283002,"Block Group 2, Census Tract 283, King County, Washington",456,95,47,50,30,43,17,26,409,99,53,31,356,104
1500000US530330283003,530330283003,"Block Group 3, Census Tract 283, King County, Washington",1018,126,60,60,0,12,60,60,958,128,127,52,831,131
1500000US530330284021,530330284021,"Block Group 1, Census Tract 284.02, King County, Washington",287,70,127,61,88,53,39,43,160,52,39,27,121,51
1500000US530330284022,530330284022,"Block Group 2, Census Tract 284.02, King County, Washington",436,111,29,23,16,18,13,15,407,111,72,36,335,107
1500000US530330284023,530330284023,"Block Group 3, Census Tract 284.02, King County, Washington",458,81,69,51,30,31,39,43,389,83,39,28,350,83
1500000US530330284024,530330284024,"Block Group 4, Census Tract 284.02, King County, Washington",612,104,213,95,33,44,180,88,399,121,56,43,343,123
1500000US530330284031,530330284031,"Block Group 1, Census Tract 284.03, King County, Washington",1306,168,355,174,86,76,269,161,951,218,122,99,829,215
1500000US530330284032,530330284032,"Block Group 2, Census Tract 284.03, King County, Washington",612,125,119,69,38,42,81,53,493,121,200,99,293,109
1500000US530330284033,530330284033,"Block Group 3, Census Tract 284.03, King County, Washington",474,119,20,31,20,31,0,12,454,125,129,69,325,129
1500000US530330285001,530330285001,"Block Group 1, Census Tract 285, King County, Washington",429,75,24,27,12,18,12,20,405,79,30,29,375,79
1500000US530330285002,530330285002,"Block Group 2, Census Tract 285, King County, Washington",495,86,68,54,68,54,0,12,427,96,127,69,300,77
1500000US530330285003,530330285003,"Block Group 3, Census Tract 285, King County, Washington",705,110,224,108,121,85,103,84,481,115,61,39,420,117
1500000US530330286001,530330286001,"Block Group 1, Census Tract 286, King County, Washington",325,67,0,12,0,12,0,12,325,67,96,57,229,71
1500000US530330286002,530330286002,"Block Group 2, Census Tract 286, King County, Washington",397,105,0,12,0,12,0,12,397,105,105,82,292,82
1500000US530330286003,530330286003,"Block Group 3, Census Tract 286, King County, Washington",426,83,18,27,0,12,18,27,408,76,104,63,304,84
1500000US530330286004,530330286004,"Block Group 4, Census Tract 286, King County, Washington",434,111,54,63,0,12,54,63,380,117,91,55,289,113
1500000US530330286005,530330286005,"Block Group 5, Census Tract 286, King County, Washington",629,127,85,67,85,67,0,12,544,120,168,76,376,117
1500000US530330286006,530330286006,"Block Group 6, Census Tract 286, King County, Washington",444,110,70,74,15,23,55,70,374,106,114,75,260,88
1500000US530330287001,530330287001,"Block Group 1, Census Tract 287, King County, Washington",331,69,40,39,40,39,0,12,291,74,91,51,200,70
1500000US530330287002,530330287002,"Block Group 2, Census Tract 287, King County, Washington",456,90,0,12,0,12,0,12,456,90,83,53,373,82
1500000US530330287003,530330287003,"Block Group 3, Census Tract 287, King County, Washington",602,91,25,25,25,25,0,12,577,93,109,57,468,97
1500000US530330287004,530330287004,"Block Group 4, Census Tract 287, King County, Washington",451,70,6,9,6,9,0,12,445,72,56,39,389,73
1500000US530330288011,530330288011,"Block Group 1, Census Tract 288.01, King County, Washington",433,63,39,26,0,12,39,26,394,65,160,47,234,57
1500000US530330288012,530330288012,"Block Group 2, Census Tract 288.01, King County, Washington",290,46,45,27,4,7,41,26,245,42,80,44,165,46
1500000US530330288013,530330288013,"Block Group 3, Census Tract 288.01, King County, Washington",23,14,7,11,7,11,0,12,16,11,0,12,16,11
1500000US530330288021,530330288021,"Block Group 1, Census Tract 288.02, King County, Washington",730,139,118,81,35,42,83,72,612,141,93,79,519,131
1500000US530330288022,530330288022,"Block Group 2, Census Tract 288.02, King County, Washington",499,93,31,29,14,25,17,29,468,94,169,86,299,86
1500000US530330288023,530330288023,"Block Group 3, Census Tract 288.02, King County, Washington",323,97,133,85,14,28,119,84,190,104,42,54,148,86
1500000US530330288024,530330288024,"Block Group 4, Census Tract 288.02, King County, Washington",755,126,205,107,33,32,172,107,550,128,101,76,449,135
1500000US530330289011,530330289011,"Block Group 1, Census Tract 289.01, King County, Washington",432,99,30,30,20,32,10,15,402,104,51,33,351,107
1500000US530330289012,530330289012,"Block Group 2, Census Tract 289.01, King County, Washington",275,71,19,26,0,12,19,26,256,70,63,37,193,67
1500000US530330289013,530330289013,"Block Group 3, Census Tract 289.01, King County, Washington",454,95,7,11,7,11,0,12,447,94,71,39,376,92
1500000US530330289014,530330289014,"Block Group 4, Census Tract 289.01, King County, Washington",434,77,33,25,0,12,33,25,401,75,60,52,341,73
1500000US530330289021,530330289021,"Block Group 1, Census Tract 289.02, King County, Washington",415,149,244,136,134,102,110,108,171,74,32,36,139,69
1500000US530330289022,530330289022,"Block Group 2, Census Tract 289.02, King County, Washington",565,129,73,55,14,24,59,49,492,131,107,66,385,128
1500000US530330289023,530330289023,"Block Group 3, Census Tract 289.02, King County, Washington",434,137,240,142,64,79,176,130,194,87,62,78,132,83
1500000US530330289024,530330289024,"Block Group 4, Census Tract 289.02, King County, Washington",474,125,158,96,55,86,103,58,316,114,0,12,316,114
1500000US530330289025,530330289025,"Block Group 5, Census Tract 289.02, King County, Washington",565,158,116,90,81,76,35,54,449,148,91,61,358,145
1500000US530330290011,530330290011,"Block Group 1, Census Tract 290.01, King County, Washington",371,71,31,27,22,22,9,14,340,69,130,48,210,61
1500000US530330290012,530330290012,"Block Group 2, Census Tract 290.01, King County, Washington",404,87,95,52,59,51,36,44,309,89,59,50,250,78
1500000US530330290013,530330290013,"Block Group 3, Census Tract 290.01, King County, Washington",504,86,17,20,17,20,0,12,487,84,151,68,336,77
1500000US530330290014,530330290014,"Block Group 4, Census Tract 290.01, King County, Washington",767,93,66,43,59,43,7,11,701,101,203,61,498,94
1500000US530330290031,530330290031,"Block Group 1, Census Tract 290.03, King County, Washington",379,103,55,46,14,25,41,38,324,110,94,83,230,90
1500000US530330290032,530330290032,"Block Group 2, Census Tract 290.03, King County, Washington",418,118,169,116,123,94,46,72,249,111,56,42,193,111
1500000US530330290033,530330290033,"Block Group 3, Census Tract 290.03, King County, Washington",503,109,48,41,0,12,48,41,455,107,40,29,415,115
1500000US530330290034,530330290034,"Block Group 4, Census Tract 290.03, King County, Washington",423,120,73,74,16,24,57,71,350,118,45,43,305,120
1500000US530330290035,530330290035,"Block Group 5, Census Tract 290.03, King County, Washington",247,78,22,30,22,30,0,12,225,78,59,46,166,67
1500000US530330290041,530330290041,"Block Group 1, Census Tract 290.04, King County, Washington",721,90,257,79,69,40,188,75,464,89,61,47,403,89
1500000US530330290042,530330290042,"Block Group 2, Census Tract 290.04, King County, Washington",543,94,255,77,116,54,139,60,288,88,47,38,241,85
1500000US530330291011,530330291011,"Block Group 1, Census Tract 291.01, King County, Washington",461,78,87,52,58,44,29,26,374,79,51,33,323,83
1500000US530330291012,530330291012,"Block Group 2, Census Tract 291.01, King County, Washington",721,93,38,36,14,21,24,29,683,83,104,66,579,87
1500000US530330291021,530330291021,"Block Group 1, Census Tract 291.02, King County, Washington",459,137,72,47,55,42,17,17,387,123,157,120,230,64
1500000US530330291022,530330291022,"Block Group 2, Census Tract 291.02, King County, Washington",372,111,23,26,16,20,7,14,349,111,36,26,313,104
1500000US530330291023,530330291023,"Block Group 3, Census Tract 291.02, King County, Washington",530,126,39,46,0,12,39,46,491,141,104,54,387,141
1500000US530330292031,530330292031,"Block Group 1, Census Tract 292.03, King County, Washington",690,93,231,71,58,40,173,71,459,104,159,54,300,95
1500000US530330292032,530330292032,"Block Group 2, Census Tract 292.03, King County, Washington",513,93,209,70,134,67,75,47,304,78,102,56,202,73
1500000US530330292041,530330292041,"Block Group 1, Census Tract 292.04, King County, Washington",1020,154,129,81,64,61,65,54,891,164,221,120,670,155
1500000US530330292042,530330292042,"Block Group 2, Census Tract 292.04, King County, Washington",629,103,100,74,64,56,36,47,529,112,94,67,435,136
1500000US530330292043,530330292043,"Block Group 3, Census Tract 292.04, King County, Washington",368,81,35,43,23,37,12,22,333,93,60,46,273,94
1500000US530330292044,530330292044,"Block Group 4, Census Tract 292.04, King County, Washington",459,139,71,79,0,12,71,79,388,139,0,12,388,139
1500000US530330292051,530330292051,"Block Group 1, Census Tract 292.05, King County, Washington",943,111,76,64,65,61,11,19,867,120,97,64,770,128
1500000US530330292052,530330292052,"Block Group 2, Census Tract 292.05, King County, Washington",401,115,173,113,48,69,125,92,228,101,17,27,211,100
1500000US530330292053,530330292053,"Block Group 3, Census Tract 292.05, King County, Washington",704,140,22,35,22,35,0,12,682,143,27,32,655,144
1500000US530330292061,530330292061,"Block Group 1, Census Tract 292.06, King County, Washington",271,77,147,73,42,44,105,61,124,59,48,36,76,54
1500000US530330292062,530330292062,"Block Group 2, Census Tract 292.06, King County, Washington",1035,124,365,94,169,72,196,75,670,124,163,62,507,122
1500000US530330292063,530330292063,"Block Group 3, Census Tract 292.06, King County, Washington",660,101,191,87,43,31,148,77,469,94,71,36,398,95
1500000US530330293031,530330293031,"Block Group 1, Census Tract 293.03, King County, Washington",348,92,41,50,0,12,41,50,307,104,97,60,210,109
1500000US530330293032,530330293032,"Block Group 2, Census Tract 293.03, King County, Washington",329,95,83,73,0,12,83,73,246,86,53,51,193,80
1500000US530330293033,530330293033,"Block Group 3, Census Tract 293.03, King County, Washington",1306,157,91,67,30,36,61,52,1215,171,242,107,973,188
1500000US530330293034,530330293034,"Block Group 4, Census Tract 293.03, King County, Washington",483,101,100,91,10,17,90,87,383,87,12,21,371,86
1500000US530330293035,530330293035,"Block Group 5, Census Tract 293.03, King County, Washington",554,133,17,26,17,26,0,12,537,135,139,94,398,110
1500000US530330293041,530330293041,"Block Group 1, Census Tract 293.04, King County, Washington",408,86,30,35,12,18,18,29,378,83,98,49,280,79
1500000US530330293042,530330293042,"Block Group 2, Census Tract 293.04, King County, Washington",473,63,0,12,0,12,0,12,473,63,145,70,328,71
1500000US530330293043,530330293043,"Block Group 3, Census Tract 293.04, King County, Washington",583,90,17,20,0,12,17,20,566,90,83,43,483,97
1500000US530330293044,530330293044,"Block Group 4, Census Tract 293.04, King County, Washington",359,55,31,22,16,18,15,22,328,57,55,32,273,64
1500000US530330293051,530330293051,"Block Group 1, Census Tract 293.05, King County, Washington",309,75,0,12,0,12,0,12,309,75,41,31,268,73
1500000US530330293052,530330293052,"Block Group 2, Census Tract 293.05, King County, Washington",411,91,158,71,75,67,83,72,253,75,57,49,196,65
1500000US530330293053,530330293053,"Block Group 3, Census Tract 293.05, King County, Washington",387,72,33,32,22,26,11,17,354,83,16,19,338,87
1500000US530330293054,530330293054,"Block Group 4, Census Tract 293.05, King County, Washington",249,58,20,22,7,12,13,18,229,58,35,24,194,63
1500000US530330293061,530330293061,"Block Group 1, Census Tract 293.06, King County, Washington",767,83,35,46,0,12,35,46,732,94,144,50,588,95
1500000US530330293062,530330293062,"Block Group 2, Census Tract 293.06, King County, Washington",503,67,33,32,15,19,18,27,470,63,92,48,378,78
1500000US530330293071,530330293071,"Block Group 1, Census Tract 293.07, King County, Washington",302,66,34,27,20,22,14,16,268,70,75,56,193,72
1500000US530330293072,530330293072,"Block Group 2, Census Tract 293.07, King County, Washington",568,78,91,57,50,44,41,37,477,82,57,37,420,83
1500000US530330293073,530330293073,"Block Group 3, Census Tract 293.07, King County, Washington",442,72,58,32,12,18,46,29,384,78,89,51,295,76
1500000US530330294031,530330294031,"Block Group 1, Census Tract 294.03, King County, Washington",671,101,72,42,54,44,18,22,599,100,157,63,442,100
1500000US530330294032,530330294032,"Block Group 2, Census Tract 294.03, King County, Washington",393,73,0,12,0,12,0,12,393,73,98,56,295,73
1500000US530330294033,530330294033,"Block Group 3, Census Tract 294.03, King County, Washington",848,131,206,101,119,80,87,70,642,120,127,81,515,116
1500000US530330294051,530330294051,"Block Group 1, Census Tract 294.05, King County, Washington",410,81,58,49,12,19,46,53,352,76,166,68,186,54
1500000US530330294052,530330294052,"Block Group 2, Census Tract 294.05, King County, Washington",500,94,45,34,15,17,30,29,455,94,72,42,383,101
1500000US530330294053,530330294053,"Block Group 3, Census Tract 294.05, King County, Washington",243,58,0,12,0,12,0,12,243,58,20,19,223,62
1500000US530330294054,530330294054,"Block Group 4, Census Tract 294.05, King County, Washington",270,63,31,37,0,12,31,37,239,51,48,36,191,57
1500000US530330294055,530330294055,"Block Group 5, Census Tract 294.05, King County, Washington",314,58,27,25,27,25,0,12,287,56,32,24,255,56
1500000US530330294061,530330294061,"Block Group 1, Census Tract 294.06, King County, Washington",628,83,103,59,40,33,63,48,525,80,50,35,475,84
1500000US530330294062,530330294062,"Block Group 2, Census Tract 294.06, King County, Washington",988,95,138,72,67,58,71,53,850,106,160,69,690,109
1500000US530330294071,530330294071,"Block Group 1, Census Tract 294.07, King County, Washington",373,88,138,59,36,26,102,51,235,77,39,34,196,72
1500000US530330294072,530330294072,"Block Group 2, Census Tract 294.07, King County, Washington",792,106,273,92,81,39,192,88,519,92,34,24,485,94
1500000US530330294073,530330294073,"Block Group 3, Census Tract 294.07, King County, Washington",400,85,31,29,10,17,21,25,369,82,151,73,218,68
1500000US530330294081,530330294081,"Block Group 1, Census Tract 294.08, King County, Washington",332,71,50,32,27,22,23,25,282,70,53,32,229,70
1500000US530330294082,530330294082,"Block Group 2, Census Tract 294.08, King County, Washington",484,62,63,47,23,27,40,40,421,71,66,34,355,67
1500000US530330294083,530330294083,"Block Group 3, Census Tract 294.08, King County, Washington",784,105,165,83,70,56,95,73,619,117,79,38,540,125
1500000US530330295021,530330295021,"Block Group 1, Census Tract 295.02, King County, Washington",779,125,108,61,26,29,82,54,671,122,116,78,555,120
1500000US530330295022,530330295022,"Block Group 2, Census Tract 295.02, King County, Washington",458,91,41,45,21,33,20,31,417,92,42,41,375,96
1500000US530330295023,530330295023,"Block Group 3, Census Tract 295.02, King County, Washington",402,90,35,42,18,29,17,29,367,80,18,28,349,85
1500000US530330295024,530330295024,"Block Group 4, Census Tract 295.02, King County, Washington",434,93,71,49,44,44,27,31,363,102,64,46,299,98
1500000US530330295031,530330295031,"Block Group 1, Census Tract 295.03, King County, Washington",329,82,115,79,72,64,43,46,214,72,7,14,207,72
1500000US530330295032,530330295032,"Block Group 2, Census Tract 295.03, King County, Washington",851,187,155,110,28,37,127,104,696,175,98,79,598,160
1500000US530330295033,530330295033,"Block Group 3, Census Tract 295.03, King County, Washington",726,153,415,146,213,93,202,128,311,119,68,73,243,103
1500000US530330295034,530330295034,"Block Group 4, Census Tract 295.03, King County, Washington",254,87,90,69,41,44,49,54,164,55,0,12,164,55
1500000US530330295035,530330295035,"Block Group 5, Census Tract 295.03, King County, Washington",746,163,242,119,44,38,198,113,504,147,113,93,391,127
1500000US530330295041,530330295041,"Block Group 1, Census Tract 295.04, King County, Washington",534,144,151,110,60,57,91,88,383,127,208,89,175,94
1500000US530330295042,530330295042,"Block Group 2, Census Tract 295.04, King County, Washington",795,142,192,122,108,86,84,77,603,158,80,69,523,165
1500000US530330295043,530330295043,"Block Group 3, Census Tract 295.04, King County, Washington",842,144,237,115,116,83,121,97,605,129,151,71,454,134
1500000US530330296011,530330296011,"Block Group 1, Census Tract 296.01, King County, Washington",369,115,79,109,19,28,60,97,290,97,107,63,183,96
1500000US530330296012,530330296012,"Block Group 2, Census Tract 296.01, King County, Washington",360,77,30,36,0,12,30,36,330,78,42,35,288,81
1500000US530330296013,530330296013,"Block Group 3, Census Tract 296.01, King County, Washington",468,96,191,75,119,66,72,56,277,71,94,66,183,64
1500000US530330296014,530330296014,"Block Group 4, Census Tract 296.01, King County, Washington",297,82,9,14,9,14,0,12,288,86,98,78,190,68
1500000US530330296015,530330296015,"Block Group 5, Census Tract 296.01, King County, Washington",502,113,16,24,16,24,0,12,486,110,33,32,453,118
1500000US530330296021,530330296021,"Block Group 1, Census Tract 296.02, King County, Washington",407,62,11,18,0,12,11,18,396,64,94,44,302,66
1500000US530330296022,530330296022,"Block Group 2, Census Tract 296.02, King County, Washington",512,78,7,11,0,12,7,11,505,78,50,38,455,77
1500000US530330296023,530330296023,"Block Group 3, Census Tract 296.02, King County, Washington",933,88,45,34,0,12,45,34,888,94,151,68,737,112
1500000US530330297001,530330297001,"Block Group 1, Census Tract 297, King County, Washington",581,112,44,42,29,34,15,24,537,121,266,91,271,111
1500000US530330297002,530330297002,"Block Group 2, Census Tract 297, King County, Washington",591,116,157,98,27,29,130,104,434,100,60,40,374,100
1500000US530330297003,530330297003,"Block Group 3, Census Tract 297, King County, Washington",757,170,373,125,209,114,164,93,384,161,59,76,325,150
1500000US530330297004,530330297004,"Block Group 4, Census Tract 297, King County, Washington",400,114,127,96,58,76,69,63,273,92,70,72,203,87
1500000US530330297005,530330297005,"Block Group 5, Census Tract 297, King County, Washington",548,123,318,99,110,56,208,118,230,112,43,40,187,124
1500000US530330298011,530330298011,"Block Group 1, Census Tract 298.01, King County, Washington",435,85,70,47,61,43,9,17,365,85,65,40,300,82
1500000US530330298012,530330298012,"Block Group 2, Census Tract 298.01, King County, Washington",720,140,67,65,37,55,30,35,653,145,80,49,573,152
1500000US530330298013,530330298013,"Block Group 3, Census Tract 298.01, King County, Washington",486,124,96,77,14,22,82,73,390,104,137,83,253,89
1500000US530330298014,530330298014,"Block Group 4, Census Tract 298.01, King County, Washington",474,96,54,41,17,23,37,38,420,95,57,43,363,92
1500000US530330298015,530330298015,"Block Group 5, Census Tract 298.01, King County, Washington",852,164,179,104,44,41,135,99,673,165,106,88,567,178
1500000US530330298021,530330298021,"Block Group 1, Census Tract 298.02, King County, Washington",307,102,47,45,15,24,32,40,260,105,74,48,186,110
1500000US530330298022,530330298022,"Block Group 2, Census Tract 298.02, King County, Washington",377,109,8,17,8,17,0,12,369,108,114,63,255,118
1500000US530330298023,530330298023,"Block Group 3, Census Tract 298.02, King County, Washington",642,132,19,42,19,42,0,12,623,130,109,72,514,136
1500000US530330298024,530330298024,"Block Group 4, Census Tract 298.02, King County, Washington",306,98,41,57,0,12,41,57,265,86,46,44,219,106
1500000US530330298025,530330298025,"Block Group 5, Census Tract 298.02, King County, Washington",625,145,104,108,32,38,72,104,521,143,94,69,427,153
1500000US530330298026,530330298026,"Block Group 6, Census Tract 298.02, King County, Washington",627,126,32,32,32,32,0,12,595,130,69,55,526,133
1500000US530330299011,530330299011,"Block Group 1, Census Tract 299.01, King County, Washington",626,87,13,17,13,17,0,12,613,88,111,52,502,97
1500000US530330299012,530330299012,"Block Group 2, Census Tract 299.01, King County, Washington",400,80,38,30,7,12,31,29,362,78,78,43,284,73
1500000US530330299013,530330299013,"Block Group 3, Census Tract 299.01, King County, Washington",542,78,100,57,30,26,70,49,442,85,92,44,350,84
1500000US530330299021,530330299021,"Block Group 1, Census Tract 299.02, King County, Washington",389,77,37,30,37,30,0,12,352,78,53,41,299,75
1500000US530330299022,530330299022,"Block Group 2, Census Tract 299.02, King County, Washington",410,64,47,35,27,31,20,18,363,65,65,31,298,67
1500000US530330299023,530330299023,"Block Group 3, Census Tract 299.02, King County, Washington",624,77,39,31,13,16,26,26,585,78,71,47,514,79
1500000US530330300031,530330300031,"Block Group 1, Census Tract 300.03, King County, Washington",405,99,36,40,36,40,0,12,369,115,47,39,322,117
1500000US530330300032,530330300032,"Block Group 2, Census Tract 300.03, King County, Washington",676,140,107,69,37,40,70,67,569,132,102,56,467,132
1500000US530330300033,530330300033,"Block Group 3, Census Tract 300.03, King County, Washington",425,99,91,84,16,24,75,78,334,93,139,83,195,98
1500000US530330300034,530330300034,"Block Group 4, Census Tract 300.03, King County, Washington",313,83,0,12,0,12,0,12,313,83,79,65,234,93
1500000US530330300035,530330300035,"Block Group 5, Census Tract 300.03, King County, Washington",582,153,0,12,0,12,0,12,582,153,75,107,507,146
1500000US530330300041,530330300041,"Block Group 1, Census Tract 300.04, King County, Washington",453,149,207,139,132,90,75,98,246,127,57,59,189,118
1500000US530330300042,530330300042,"Block Group 2, Census Tract 300.04, King County, Washington",714,193,139,101,83,53,56,89,575,185,39,45,536,188
1500000US530330300043,530330300043,"Block Group 3, Census Tract 300.04, King County, Washington",467,145,24,38,0,12,24,38,443,144,76,95,367,144
1500000US530330300044,530330300044,"Block Group 4, Census Tract 300.04, King County, Washington",327,104,31,38,19,29,12,22,296,105,58,60,238,100
1500000US530330300045,530330300045,"Block Group 5, Census Tract 300.04, King County, Washington",536,162,375,168,181,141,194,124,161,110,91,94,70,60
1500000US530330300046,530330300046,"Block Group 6, Census Tract 300.04, King County, Washington",583,166,238,147,184,149,54,51,345,143,96,75,249,134
1500000US530330300051,530330300051,"Block Group 1, Census Tract 300.05, King County, Washington",517,83,156,73,62,37,94,69,361,80,93,52,268,76
1500000US530330300052,530330300052,"Block Group 2, Census Tract 300.05, King County, Washington",551,78,68,44,17,19,51,42,483,77,113,60,370,76
1500000US530330300053,530330300053,"Block Group 3, Census Tract 300.05, King County, Washington",769,113,297,100,126,76,171,78,472,110,66,47,406,103
1500000US530330300061,530330300061,"Block Group 1, Census Tract 300.06, King County, Washington",552,109,125,76,56,58,69,52,427,109,50,35,377,110
1500000US530330300062,530330300062,"Block Group 2, Census Tract 300.06, King County, Washington",1095,108,457,116,187,101,270,83,638,106,268,79,370,97
1500000US530330301001,530330301001,"Block Group 1, Census Tract 301, King County, Washington",327,87,31,37,31,37,0,12,296,86,64,57,232,83
1500000US530330301002,530330301002,"Block Group 2, Census Tract 301, King County, Washington",431,96,22,25,20,26,2,12,409,95,30,27,379,101
1500000US530330301003,530330301003,"Block Group 3, Census Tract 301, King County, Washington",612,132,59,59,45,53,14,26,553,135,28,31,525,137
1500000US530330301004,530330301004,"Block Group 4, Census Tract 301, King County, Washington",386,116,0,12,0,12,0,12,386,116,178,125,208,72
1500000US530330301005,530330301005,"Block Group 5, Census Tract 301, King County, Washington",418,145,184,98,0,12,184,98,234,133,25,29,209,133
1500000US530330301006,530330301006,"Block Group 6, Census Tract 301, King County, Washington",378,74,8,12,0,12,8,12,370,75,80,57,290,86
1500000US530330301007,530330301007,"Block Group 7, Census Tract 301, King County, Washington",404,102,0,12,0,12,0,12,404,102,95,57,309,111
1500000US530330302011,530330302011,"Block Group 1, Census Tract 302.01, King County, Washington",332,90,80,59,32,26,48,59,252,74,56,28,196,75
1500000US530330302012,530330302012,"Block Group 2, Census Tract 302.01, King County, Washington",560,115,227,112,73,70,154,98,333,89,79,65,254,82
1500000US530330302013,530330302013,"Block Group 3, Census Tract 302.01, King County, Washington",496,102,43,34,36,33,7,11,453,113,27,23,426,115
1500000US530330302014,530330302014,"Block Group 4, Census Tract 302.01, King County, Washington",708,111,169,78,81,55,88,54,539,114,81,46,458,118
1500000US530330302021,530330302021,"Block Group 1, Census Tract 302.02, King County, Washington",321,94,49,55,17,26,32,46,272,84,75,38,197,82
1500000US530330302022,530330302022,"Block Group 2, Census Tract 302.02, King County, Washington",563,129,131,85,21,31,110,78,432,115,203,88,229,96
1500000US530330302023,530330302023,"Block Group 3, Census Tract 302.02, King County, Washington",245,95,52,47,31,38,21,27,193,103,91,97,102,58
1500000US530330302024,530330302024,"Block Group 4, Census Tract 302.02, King County, Washington",639,144,175,105,133,89,42,52,464,149,111,85,353,141
1500000US530330302025,530330302025,"Block Group 5, Census Tract 302.02, King County, Washington",603,166,104,68,89,60,15,27,499,164,129,76,370,154
1500000US530330303041,530330303041,"Block Group 1, Census Tract 303.04, King County, Washington",570,84,46,30,24,22,22,24,524,80,84,42,440,84
1500000US530330303042,530330303042,"Block Group 2, Census Tract 303.04, King County, Washington",528,84,156,78,102,65,54,41,372,71,55,35,317,78
1500000US530330303051,530330303051,"Block Group 1, Census Tract 303.05, King County, Washington",753,127,280,123,107,89,173,105,473,98,81,72,392,102
1500000US530330303052,530330303052,"Block Group 2, Census Tract 303.05, King County, Washington",763,155,105,80,9,19,96,80,658,154,209,94,449,145
1500000US530330303053,530330303053,"Block Group 3, Census Tract 303.05, King County, Washington",588,110,39,50,0,12,39,50,549,115,109,60,440,128
1500000US530330303061,530330303061,"Block Group 1, Census Tract 303.06, King County, Washington",479,75,101,56,53,42,48,49,378,75,105,54,273,69
1500000US530330303062,530330303062,"Block Group 2, Census Tract 303.06, King County, Washington",405,75,0,12,0,12,0,12,405,75,51,37,354,78
1500000US530330303063,530330303063,"Block Group 3, Census Tract 303.06, King County, Washington",699,97,62,37,16,21,46,35,637,96,170,78,467,92
1500000US530330303064,530330303064,"Block Group 4, Census Tract 303.06, King County, Washington",362,77,47,43,17,21,30,37,315,81,87,64,228,66
1500000US530330303081,530330303081,"Block Group 1, Census Tract 303.08, King County, Washington",242,82,0,12,0,12,0,12,242,82,41,39,201,74
1500000US530330303082,530330303082,"Block Group 2, Census Tract 303.08, King County, Washington",670,129,76,57,39,53,37,43,594,136,146,89,448,114
1500000US530330303083,530330303083,"Block Group 3, Census Tract 303.08, King County, Washington",621,122,83,80,83,80,0,12,538,118,39,39,499,121
1500000US530330303084,530330303084,"Block Group 4, Census Tract 303.08, King County, Washington",764,139,72,50,20,26,52,46,692,142,117,99,575,138
1500000US530330303091,530330303091,"Block Group 1, Census Tract 303.09, King County, Washington",373,94,76,54,0,12,76,54,297,92,32,37,265,92
1500000US530330303092,530330303092,"Block Group 2, Census Tract 303.09, King County, Washington",702,166,94,84,53,66,41,51,608,181,45,55,563,183
1500000US530330303093,530330303093,"Block Group 3, Census Tract 303.09, King County, Washington",489,120,121,93,0,12,121,93,368,109,55,56,313,89
1500000US530330303094,530330303094,"Block Group 4, Census Tract 303.09, King County, Washington",846,146,141,96,90,95,51,52,705,140,60,64,645,139
1500000US530330303101,530330303101,"Block Group 1, Census Tract 303.10, King County, Washington",256,65,20,21,0,12,20,21,236,65,50,42,186,62
1500000US530330303102,530330303102,"Block Group 2, Census Tract 303.10, King County, Washington",301,67,28,20,0,12,28,20,273,70,37,26,236,63
1500000US530330303103,530330303103,"Block Group 3, Census Tract 303.10, King County, Washington",499,89,0,12,0,12,0,12,499,89,42,32,457,86
1500000US530330303104,530330303104,"Block Group 4, Census Tract 303.10, King County, Washington",922,111,107,65,9,16,98,63,815,126,306,104,509,121
1500000US530330303111,530330303111,"Block Group 1, Census Tract 303.11, King County, Washington",413,76,23,26,7,12,16,24,390,76,70,38,320,78
1500000US530330303112,530330303112,"Block Group 2, Census Tract 303.11, King County, Washington",570,105,159,98,48,62,111,83,411,96,29,23,382,97
1500000US530330303113,530330303113,"Block Group 3, Census Tract 303.11, King County, Washington",446,70,51,32,21,23,30,29,395,72,137,61,258,64
1500000US530330303114,530330303114,"Block Group 4, Census Tract 303.11, King County, Washington",279,82,63,63,39,52,24,37,216,67,34,25,182,70
1500000US530330303121,530330303121,"Block Group 1, Census Tract 303.12, King County, Washington",576,108,192,84,115,64,77,60,384,109,59,53,325,102
1500000US530330303122,530330303122,"Block Group 2, Census Tract 303.12, King County, Washington",548,112,28,23,28,23,0,12,520,110,173,87,347,104
1500000US530330303123,530330303123,"Block Group 3, Census Tract 303.12, King County, Washington",319,69,73,45,22,26,51,40,246,66,22,25,224,64
1500000US530330303124,530330303124,"Block Group 4, Census Tract 303.12, King County, Washington",349,82,23,24,0,12,23,24,326,84,56,41,270,86
1500000US530330303131,530330303131,"Block Group 1, Census Tract 303.13, King County, Washington",749,122,182,82,59,31,123,75,567,121,203,78,364,124
1500000US530330303132,530330303132,"Block Group 2, Census Tract 303.13, King County, Washington",866,131,250,100,112,61,138,80,616,124,93,53,523,130
1500000US530330303141,530330303141,"Block Group 1, Census Tract 303.14, King County, Washington",828,127,213,112,132,92,81,71,615,118,169,58,446,117
1500000US530330303142,530330303142,"Block Group 2, Census Tract 303.14, King County, Washington",392,78,37,29,18,20,19,21,355,82,102,50,253,85
1500000US530330303143,530330303143,"Block Group 3, Census Tract 303.14, King County, Washington",718,129,115,89,115,89,0,12,603,118,302,94,301,82
1500000US530330304011,530330304011,"Block Group 1, Census Tract 304.01, King County, Washington",865,142,170,111,34,42,136,105,695,145,190,88,505,143
1500000US530330304012,530330304012,"Block Group 2, Census Tract 304.01, King County, Washington",612,125,41,65,0,12,41,65,571,114,117,70,454,128
1500000US530330304013,530330304013,"Block Group 3, Census Tract 304.01, King County, Washington",533,132,64,54,0,12,64,54,469,132,122,101,347,121
1500000US530330304014,530330304014,"Block Group 4, Census Tract 304.01, King County, Washington",413,122,72,72,34,40,38,61,341,123,62,49,279,117
1500000US530330304015,530330304015,"Block Group 5, Census Tract 304.01, King County, Washington",700,145,209,132,45,51,164,125,491,130,19,30,472,130
1500000US530330304031,530330304031,"Block Group 1, Census Tract 304.03, King County, Washington",595,86,103,70,43,50,60,51,492,70,194,71,298,63
1500000US530330304032,530330304032,"Block Group 2, Census Tract 304.03, King County, Washington",415,69,0,12,0,12,0,12,415,69,75,51,340,70
1500000US530330304033,530330304033,"Block Group 3, Census Tract 304.03, King County, Washington",647,98,22,20,9,13,13,16,625,102,119,47,506,103
1500000US530330304041,530330304041,"Block Group 1, Census Tract 304.04, King County, Washington",653,68,73,49,66,47,7,12,580,79,83,42,497,82
1500000US530330304042,530330304042,"Block Group 2, Census Tract 304.04, King County, Washington",484,68,34,27,17,19,17,19,450,73,107,48,343,72
1500000US530330304043,530330304043,"Block Group 3, Census Tract 304.04, King County, Washington",480,79,33,42,25,40,8,14,447,85,158,69,289,81
1500000US530330305011,530330305011,"Block Group 1, Census Tract 305.01, King County, Washington",396,60,166,52,104,45,62,41,230,43,36,21,194,42
1500000US530330305012,530330305012,"Block Group 2, Census Tract 305.01, King County, Washington",535,55,181,60,80,35,101,46,354,65,127,49,227,64
1500000US530330305031,530330305031,"Block Group 1, Census Tract 305.03, King County, Washington",909,153,245,88,174,74,71,60,664,139,196,109,468,106
1500000US530330305032,530330305032,"Block Group 2, Census Tract 305.03, King County, Washington",1182,166,136,92,45,42,91,87,1046,152,227,104,819,156
1500000US530330305041,530330305041,"Block Group 1, Census Tract 305.04, King County, Washington",287,77,25,25,5,8,20,23,262,76,50,25,212,76
1500000US530330305042,530330305042,"Block Group 2, Census Tract 305.04, King County, Washington",451,86,59,29,36,25,23,18,392,88,72,41,320,89
1500000US530330305043,530330305043,"Block Group 3, Census Tract 305.04, King County, Washington",450,95,173,82,59,43,114,72,277,78,48,38,229,79
1500000US530330305044,530330305044,"Block Group 4, Census Tract 305.04, King County, Washington",670,92,114,62,39,25,75,56,556,97,182,58,374,96
1500000US530330306001,530330306001,"Block Group 1, Census Tract 306, King County, Washington",421,91,36,45,0,12,36,45,385,104,96,52,289,106
1500000US530330306002,530330306002,"Block Group 2, Census Tract 306, King County, Washington",594,118,132,92,13,20,119,90,462,110,73,62,389,117
1500000US530330306003,530330306003,"Block Group 3, Census Tract 306, King County, Washington",602,102,159,81,58,72,101,54,443,101,85,72,358,112
1500000US530330306004,530330306004,"Block Group 4, Census Tract 306, King County, Washington",427,98,175,79,39,33,136,82,252,82,38,59,214,86
1500000US530330307001,530330307001,"Block Group 1, Census Tract 307, King County, Washington",466,88,238,89,156,83,82,51,228,69,22,25,206,66
1500000US530330307002,530330307002,"Block Group 2, Census Tract 307, King County, Washington",553,97,134,61,83,50,51,48,419,83,61,41,358,77
1500000US530330307003,530330307003,"Block Group 3, Census Tract 307, King County, Washington",470,102,68,45,27,26,41,39,402,102,126,62,276,94
1500000US530330308011,530330308011,"Block Group 1, Census Tract 308.01, King County, Washington",583,115,160,101,85,84,75,70,423,103,93,67,330,101
1500000US530330308012,530330308012,"Block Group 2, Census Tract 308.01, King County, Washington",586,124,357,134,262,130,95,70,229,102,12,20,217,97
1500000US530330308013,530330308013,"Block Group 3, Census Tract 308.01, King County, Washington",1163,151,362,140,157,96,205,111,801,180,196,79,605,170
1500000US530330308021,530330308021,"Block Group 1, Census Tract 308.02, King County, Washington",440,88,120,57,27,26,93,51,320,77,29,28,291,78
1500000US530330308022,530330308022,"Block Group 2, Census Tract 308.02, King County, Washington",547,100,109,57,29,20,80,54,438,86,149,79,289,67
1500000US530330308023,530330308023,"Block Group 3, Census Tract 308.02, King County, Washington",413,107,144,78,80,70,64,46,269,70,23,23,246,72
1500000US530330309011,530330309011,"Block Group 1, Census Tract 309.01, King County, Washington",665,83,107,49,39,30,68,37,558,81,113,44,445,68
1500000US530330309012,530330309012,"Block Group 2, Census Tract 309.01, King County, Washington",524,102,182,90,36,27,146,86,342,74,70,49,272,64
1500000US530330309021,530330309021,"Block Group 1, Census Tract 309.02, King County, Washington",872,151,186,82,90,65,96,58,686,150,267,105,419,110
1500000US530330309022,530330309022,"Block Group 2, Census Tract 309.02, King County, Washington",508,97,53,55,19,16,34,51,455,103,144,85,311,91
1500000US530330309023,530330309023,"Block Group 3, Census Tract 309.02, King County, Washington",741,142,201,98,84,52,117,79,540,133,134,91,406,131
1500000US530330310001,530330310001,"Block Group 1, Census Tract 310, King County, Washington",913,84,38,39,17,27,21,24,875,89,118,46,757,94
1500000US530330310002,530330310002,"Block Group 2, Census Tract 310, King County, Washington",557,81,25,23,17,18,8,12,532,80,85,45,447,87
1500000US530330311001,530330311001,"Block Group 1, Census Tract 311, King County, Washington",431,92,80,58,31,31,49,48,351,86,108,80,243,81
1500000US530330311002,530330311002,"Block Group 2, Census Tract 311, King County, Washington",577,92,95,76,78,76,17,9,482,73,83,35,399,75
1500000US530330311003,530330311003,"Block Group 3, Census Tract 311, King County, Washington",708,85,138,34,53,20,85,32,570,83,163,41,407,80
1500000US530330311004,530330311004,"Block Group 4, Census Tract 311, King County, Washington",523,102,112,71,86,68,26,20,411,99,124,68,287,87
1500000US530330311005,530330311005,"Block Group 5, Census Tract 311, King County, Washington",372,82,163,84,82,61,81,52,209,50,75,38,134,38
1500000US530330312021,530330312021,"Block Group 1, Census Tract 312.02, King County, Washington",534,115,49,69,49,69,0,12,485,97,128,72,357,107
1500000US530330312022,530330312022,"Block Group 2, Census Tract 312.02, King County, Washington",341,76,38,35,32,32,6,7,303,73,59,42,244,79
1500000US530330312023,530330312023,"Block Group 3, Census Tract 312.02, King County, Washington",444,82,0,12,0,12,0,12,444,82,91,73,353,75
1500000US530330312024,530330312024,"Block Group 4, Census Tract 312.02, King County, Washington",560,108,15,24,15,24,0,12,545,114,127,76,418,116
1500000US530330312025,530330312025,"Block Group 5, Census Tract 312.02, King County, Washington",376,98,95,39,56,27,39,33,281,90,79,44,202,85
1500000US530330312041,530330312041,"Block Group 1, Census Tract 312.04, King County, Washington",436,116,35,37,16,22,19,29,401,125,32,33,369,126
1500000US530330312042,530330312042,"Block Group 2, Census Tract 312.04, King County, Washington",423,86,0,12,0,12,0,12,423,86,86,83,337,86
1500000US530330312043,530330312043,"Block Group 3, Census Tract 312.04, King County, Washington",524,86,53,50,0,12,53,50,471,80,87,43,384,94
1500000US530330312044,530330312044,"Block Group 4, Census Tract 312.04, King County, Washington",479,121,0,12,0,12,0,12,479,121,136,98,343,107
1500000US530330312045,530330312045,"Block Group 5, Census Tract 312.04, King County, Washington",447,99,0,12,0,12,0,12,447,99,109,86,338,91
1500000US530330312051,530330312051,"Block Group 1, Census Tract 312.05, King County, Washington",864,147,308,134,115,103,193,108,556,124,39,37,517,129
1500000US530330312052,530330312052,"Block Group 2, Census Tract 312.05, King County, Washington",685,147,118,69,33,38,85,59,567,137,138,79,429,126
1500000US530330312053,530330312053,"Block Group 3, Census Tract 312.05, King County, Washington",647,123,93,76,34,40,59,68,554,108,79,57,475,111
1500000US530330312061,530330312061,"Block Group 1, Census Tract 312.06, King County, Washington",386,82,53,52,28,32,25,39,333,76,54,45,279,80
1500000US530330312062,530330312062,"Block Group 2, Census Tract 312.06, King County, Washington",613,96,15,18,7,12,8,13,598,94,189,65,409,92
1500000US530330312063,530330312063,"Block Group 3, Census Tract 312.06, King County, Washington",763,98,169,73,81,56,88,68,594,96,91,49,503,94
1500000US530330313011,530330313011,"Block Group 1, Census Tract 313.01, King County, Washington",493,61,78,47,24,29,54,39,415,61,46,23,369,63
1500000US530330313012,530330313012,"Block Group 2, Census Tract 313.01, King County, Washington",514,57,28,20,6,9,22,17,486,62,135,47,351,66
1500000US530330313021,530330313021,"Block Group 1, Census Tract 313.02, King County, Washington",382,63,10,15,0,12,10,15,372,64,65,43,307,61
1500000US530330313022,530330313022,"Block Group 2, Census Tract 313.02, King County, Washington",422,79,56,40,0,12,56,40,366,73,43,32,323,74
1500000US530330313023,530330313023,"Block Group 3, Census Tract 313.02, King County, Washington",407,66,63,39,49,35,14,16,344,70,115,52,229,70
1500000US530330313024,530330313024,"Block Group 4, Census Tract 313.02, King County, Washington",426,87,126,61,51,50,75,45,300,82,94,69,206,72
1500000US530330314001,530330314001,"Block Group 1, Census Tract 314, King County, Washington",435,134,164,125,72,66,92,102,271,121,41,35,230,129
1500000US530330314002,530330314002,"Block Group 2, Census Tract 314, King County, Washington",612,162,47,49,23,38,24,29,565,162,96,81,469,152
1500000US530330314003,530330314003,"Block Group 3, Census Tract 314, King County, Washington",528,100,39,39,22,26,17,29,489,103,91,51,398,117
1500000US530330314004,530330314004,"Block Group 4, Census Tract 314, King County, Washington",409,104,133,114,116,119,17,27,276,98,62,57,214,85
1500000US530330314005,530330314005,"Block Group 5, Census Tract 314, King County, Washington",363,98,94,95,0,12,94,95,269,82,76,68,193,62
1500000US530330315011,530330315011,"Block Group 1, Census Tract 315.01, King County, Washington",424,95,9,12,9,12,0,12,415,97,112,70,303,98
1500000US530330315012,530330315012,"Block Group 2, Census Tract 315.01, King County, Washington",562,95,7,9,5,8,2,5,555,96,115,48,440,98
1500000US530330315013,530330315013,"Block Group 3, Census Tract 315.01, King County, Washington",491,112,23,24,0,12,23,24,468,113,142,88,326,123
1500000US530330315021,530330315021,"Block Group 1, Census Tract 315.02, King County, Washington",448,90,22,24,22,24,0,12,426,95,104,66,322,91
1500000US530330315022,530330315022,"Block Group 2, Census Tract 315.02, King County, Washington",527,74,43,48,28,42,15,21,484,75,197,68,287,66
1500000US530330315023,530330315023,"Block Group 3, Census Tract 315.02, King County, Washington",695,86,71,48,44,44,27,28,624,91,167,63,457,94
1500000US530330316011,530330316011,"Block Group 1, Census Tract 316.01, King County, Washington",746,71,4,8,4,8,0,12,742,73,81,58,661,84
1500000US530330316012,530330316012,"Block Group 2, Census Tract 316.01, King County, Washington",723,75,30,27,0,12,30,27,693,76,164,73,529,85
1500000US530330316013,530330316013,"Block Group 3, Census Tract 316.01, King County, Washington",531,74,99,55,32,30,67,64,432,68,49,31,383,72
1500000US530330316031,530330316031,"Block Group 1, Census Tract 316.03, King County, Washington",567,83,100,73,63,48,37,49,467,84,48,34,419,87
1500000US530330316032,530330316032,"Block Group 2, Census Tract 316.03, King County, Washington",474,103,27,26,0,12,27,26,447,102,135,86,312,97
1500000US530330316033,530330316033,"Block Group 3, Census Tract 316.03, King County, Washington",565,116,41,44,26,41,15,18,524,119,51,35,473,122
1500000US530330316034,530330316034,"Block Group 4, Census Tract 316.03, King County, Washington",501,76,0,12,0,12,0,12,501,76,52,38,449,80
1500000US530330316041,530330316041,"Block Group 1, Census Tract 316.04, King County, Washington",945,99,40,37,21,23,19,22,905,105,150,59,755,104
1500000US530330316042,530330316042,"Block Group 2, Census Tract 316.04, King County, Washington",324,68,10,16,0,12,10,16,314,64,38,31,276,65
1500000US530330316043,530330316043,"Block Group 3, Census Tract 316.04, King County, Washington",507,87,33,42,33,42,0,12,474,84,112,59,362,82
1500000US530330316051,530330316051,"Block Group 1, Census Tract 316.05, King County, Washington",462,80,39,46,39,46,0,12,423,78,107,47,316,84
1500000US530330316052,530330316052,"Block Group 2, Census Tract 316.05, King County, Washington",431,78,57,53,18,27,39,45,374,75,70,46,304,63
1500000US530330316053,530330316053,"Block Group 3, Census Tract 316.05, King County, Washington",403,81,0,12,0,12,0,12,403,81,46,35,357,84
1500000US530330317031,530330317031,"Block Group 1, Census Tract 317.03, King County, Washington",340,72,14,23,0,12,14,23,326,71,35,28,291,75
1500000US530330317032,530330317032,"Block Group 2, Census Tract 317.03, King County, Washington",482,105,0,12,0,12,0,12,482,105,75,49,407,104
1500000US530330317033,530330317033,"Block Group 3, Census Tract 317.03, King County, Washington",625,101,168,105,62,69,106,81,457,126,80,53,377,125
1500000US530330317034,530330317034,"Block Group 4, Census Tract 317.03, King County, Washington",454,108,49,44,32,35,17,26,405,110,78,56,327,121
1500000US530330317035,530330317035,"Block Group 5, Census Tract 317.03, King County, Washington",735,128,17,29,0,12,17,29,718,137,86,55,632,137
1500000US530330317041,530330317041,"Block Group 1, Census Tract 317.04, King County, Washington",332,60,27,25,20,22,7,11,305,57,79,43,226,56
1500000US530330317042,530330317042,"Block Group 2, Census Tract 317.04, King County, Washington",578,95,113,72,57,68,56,38,465,93,50,42,415,96
1500000US530330317043,530330317043,"Block Group 3, Census Tract 317.04, King County, Washington",810,113,88,53,61,47,27,24,722,111,131,92,591,118
1500000US530330317051,530330317051,"Block Group 1, Census Tract 317.05, King County, Washington",435,70,18,22,7,12,11,16,417,71,39,29,378,76
1500000US530330317052,530330317052,"Block Group 2, Census Tract 317.05, King County, Washington",355,77,0,12,0,12,0,12,355,77,47,36,308,80
1500000US530330317053,530330317053,"Block Group 3, Census Tract 317.05, King County, Washington",513,101,57,36,38,31,19,20,456,106,60,43,396,103
1500000US530330317061,530330317061,"Block Group 1, Census Tract 317.06, King County, Washington",429,102,0,12,0,12,0,12,429,102,99,88,330,84
1500000US530330317062,530330317062,"Block Group 2, Census Tract 317.06, King County, Washington",975,123,170,119,36,40,134,114,805,152,257,138,548,151
1500000US530330317063,530330317063,"Block Group 3, Census Tract 317.06, King County, Washington",481,92,95,65,36,44,59,44,386,97,19,27,367,94
1500000US530330317064,530330317064,"Block Group 4, Census Tract 317.06, King County, Washington",647,112,85,79,0,12,85,79,562,110,79,54,483,122
1500000US530330318001,530330318001,"Block Group 1, Census Tract 318, King County, Washington",650,74,14,17,14,17,0,12,636,78,69,33,567,84
1500000US530330318002,530330318002,"Block Group 2, Census Tract 318, King County, Washington",485,68,13,21,13,21,0,12,472,72,93,46,379,73
1500000US530330318003,530330318003,"Block Group 3, Census Tract 318, King County, Washington",571,67,34,41,0,12,34,41,537,67,121,59,416,81
1500000US530330319031,530330319031,"Block Group 1, Census Tract 319.03, King County, Washington",620,80,0,12,0,12,0,12,620,80,138,87,482,100
1500000US530330319032,530330319032,"Block Group 2, Census Tract 319.03, King County, Washington",656,94,102,90,87,90,15,25,554,100,131,58,423,86
1500000US530330319033,530330319033,"Block Group 3, Census Tract 319.03, King County, Washington",334,70,15,23,15,23,0,12,319,77,94,49,225,79
1500000US530330319034,530330319034,"Block Group 4, Census Tract 319.03, King County, Washington",383,87,15,25,15,25,0,12,368,92,109,71,259,75
1500000US530330319035,530330319035,"Block Group 5, Census Tract 319.03, King County, Washington",404,88,88,73,49,67,39,33,316,70,15,24,301,66
1500000US530330319041,530330319041,"Block Group 1, Census Tract 319.04, King County, Washington",636,78,14,17,0,12,14,17,622,80,107,51,515,91
1500000US530330319042,530330319042,"Block Group 2, Census Tract 319.04, King County, Washington",304,64,41,44,10,15,31,42,263,58,38,32,225,64
1500000US530330319043,530330319043,"Block Group 3, Census Tract 319.04, King County, Washington",379,69,29,36,0,12,29,36,350,72,121,59,229,67
1500000US530330319061,530330319061,"Block Group 1, Census Tract 319.06, King County, Washington",609,76,35,40,35,40,0,12,574,81,120,64,454,92
1500000US530330319062,530330319062,"Block Group 2, Census Tract 319.06, King County, Washington",783,80,15,18,15,18,0,12,768,82,148,73,620,99
1500000US530330319071,530330319071,"Block Group 1, Census Tract 319.07, King County, Washington",253,57,0,12,0,12,0,12,253,57,72,58,181,50
1500000US530330319072,530330319072,"Block Group 2, Census Tract 319.07, King County, Washington",306,77,0,12,0,12,0,12,306,77,66,47,240,84
1500000US530330319073,530330319073,"Block Group 3, Census Tract 319.07, King County, Washington",991,161,29,36,14,23,15,29,962,164,78,51,884,175
1500000US530330319074,530330319074,"Block Group 4, Census Tract 319.07, King County, Washington",845,123,41,37,41,37,0,12,804,119,47,46,757,130
1500000US530330319075,530330319075,"Block Group 5, Census Tract 319.07, King County, Washington",380,97,38,44,38,44,0,12,342,96,78,57,264,85
1500000US530330319081,530330319081,"Block Group 1, Census Tract 319.08, King County, Washington",690,110,12,23,12,23,0,12,678,108,126,53,552,120
1500000US530330319082,530330319082,"Block Group 2, Census Tract 319.08, King County, Washington",740,112,61,40,10,15,51,37,679,113,104,68,575,120
1500000US530330319083,530330319083,"Block Group 3, Census Tract 319.08, King County, Washington",458,99,60,40,33,29,27,28,398,104,132,72,266,89
1500000US530330319091,530330319091,"Block Group 1, Census Tract 319.09, King County, Washington",723,67,60,39,27,25,33,34,663,73,157,72,506,74
1500000US530330319092,530330319092,"Block Group 2, Census Tract 319.09, King County, Washington",438,53,0,12,0,12,0,12,438,53,91,50,347,60
1500000US530330320021,530330320021,"Block Group 1, Census Tract 320.02, King County, Washington",656,82,61,37,21,23,40,38,595,84,109,50,486,83
1500000US530330320022,530330320022,"Block Group 2, Census Tract 320.02, King County, Washington",580,79,40,50,40,50,0,12,540,84,108,68,432,92
1500000US530330320031,530330320031,"Block Group 1, Census Tract 320.03, King County, Washington",624,90,34,26,7,12,27,26,590,90,125,58,465,91
1500000US530330320032,530330320032,"Block Group 2, Census Tract 320.03, King County, Washington",499,92,26,21,26,21,0,12,473,96,108,65,365,92
1500000US530330320033,530330320033,"Block Group 3, Census Tract 320.03, King County, Washington",362,79,10,16,0,12,10,16,352,79,54,35,298,80
1500000US530330320034,530330320034,"Block Group 4, Census Tract 320.03, King County, Washington",440,104,31,29,11,16,20,25,409,104,62,42,347,102
1500000US530330320051,530330320051,"Block Group 1, Census Tract 320.05, King County, Washington",288,80,54,79,0,12,54,79,234,74,70,48,164,58
1500000US530330320052,530330320052,"Block Group 2, Census Tract 320.05, King County, Washington",433,147,39,46,19,32,20,30,394,149,72,106,322,126
1500000US530330320053,530330320053,"Block Group 3, Census Tract 320.05, King County, Washington",408,97,54,57,54,57,0,12,354,105,78,60,276,103
1500000US530330320054,530330320054,"Block Group 4, Census Tract 320.05, King County, Washington",466,111,28,35,0,12,28,35,438,106,54,52,384,105
1500000US530330320055,530330320055,"Block Group 5, Census Tract 320.05, King County, Washington",542,133,78,61,38,46,40,47,464,145,77,78,387,131
1500000US530330320056,530330320056,"Block Group 6, Census Tract 320.05, King County, Washington",268,60,0,12,0,12,0,12,268,60,111,74,157,67
1500000US530330320061,530330320061,"Block Group 1, Census Tract 320.06, King County, Washington",440,70,46,34,46,34,0,12,394,69,76,49,318,70
1500000US530330320062,530330320062,"Block Group 2, Census Tract 320.06, King County, Washington",815,106,0,12,0,12,0,12,815,106,205,76,610,102
1500000US530330320063,530330320063,"Block Group 3, Census Tract 320.06, King County, Washington",639,96,45,43,0,12,45,43,594,88,116,51,478,93
1500000US530330320071,530330320071,"Block Group 1, Census Tract 320.07, King County, Washington",421,83,0,12,0,12,0,12,421,83,57,41,364,93
1500000US530330320072,530330320072,"Block Group 2, Census Tract 320.07, King County, Washington",510,82,11,17,11,17,0,12,499,79,100,56,399,89
1500000US530330320073,530330320073,"Block Group 3, Census Tract 320.07, King County, Washington",402,65,98,52,21,24,77,52,304,76,98,61,206,62
1500000US530330320081,530330320081,"Block Group 1, Census Tract 320.08, King County, Washington",498,78,9,14,9,14,0,12,489,77,54,34,435,86
1500000US530330320082,530330320082,"Block Group 2, Census Tract 320.08, King County, Washington",578,95,54,58,54,58,0,12,524,90,81,50,443,85
1500000US530330320083,530330320083,"Block Group 3, Census Tract 320.08, King County, Washington",435,87,34,26,15,17,19,22,401,84,39,38,362,83
1500000US530330320101,530330320101,"Block Group 1, Census Tract 320.10, King County, Washington",602,108,18,27,18,27,0,12,584,108,175,86,409,102
1500000US530330320102,530330320102,"Block Group 2, Census Tract 320.10, King County, Washington",441,77,0,12,0,12,0,12,441,77,40,48,401,75
1500000US530330320103,530330320103,"Block Group 3, Census Tract 320.10, King County, Washington",471,91,26,41,0,12,26,41,445,105,64,54,381,96
1500000US530330320104,530330320104,"Block Group 4, Census Tract 320.10, King County, Washington",588,99,42,60,0,12,42,60,546,94,65,52,481,92
1500000US530330320111,530330320111,"Block Group 1, Census Tract 320.11, King County, Washington",696,89,0,12,0,12,0,12,696,89,140,61,556,84
1500000US530330320112,530330320112,"Block Group 2, Census Tract 320.11, King County, Washington",736,98,20,23,8,13,12,20,716,95,37,27,679,98
1500000US530330321021,530330321021,"Block Group 1, Census Tract 321.02, King County, Washington",462,69,19,21,9,14,10,15,443,70,23,20,420,74
1500000US530330321022,530330321022,"Block Group 2, Census Tract 321.02, King County, Washington",315,73,47,37,47,37,0,12,268,64,60,32,208,62
1500000US530330321023,530330321023,"Block Group 3, Census Tract 321.02, King County, Washington",563,74,9,14,9,14,0,12,554,75,113,49,441,86
1500000US530330321024,530330321024,"Block Group 4, Census Tract 321.02, King County, Washington",517,62,0,12,0,12,0,12,517,62,69,41,448,69
1500000US530330321031,530330321031,"Block Group 1, Census Tract 321.03, King County, Washington",346,91,5,9,0,12,5,9,341,91,0,12,341,91
1500000US530330321032,530330321032,"Block Group 2, Census Tract 321.03, King County, Washington",499,88,45,59,7,13,38,59,454,83,93,56,361,83
1500000US530330321033,530330321033,"Block Group 3, Census Tract 321.03, King County, Washington",713,133,70,67,45,59,25,31,643,134,76,65,567,132
1500000US530330321034,530330321034,"Block Group 4, Census Tract 321.03, King County, Washington",501,96,8,14,8,14,0,12,493,97,53,40,440,99
1500000US530330321041,530330321041,"Block Group 1, Census Tract 321.04, King County, Washington",858,145,13,21,13,21,0,12,845,148,128,68,717,143
1500000US530330321042,530330321042,"Block Group 2, Census Tract 321.04, King County, Washington",948,170,121,116,105,114,16,27,827,173,144,92,683,162
1500000US530330321043,530330321043,"Block Group 3, Census Tract 321.04, King County, Washington",692,131,120,127,66,97,54,87,572,136,33,36,539,140
1500000US530330322031,530330322031,"Block Group 1, Census Tract 322.03, King County, Washington",737,101,32,35,0,12,32,35,705,104,58,43,647,108
1500000US530330322032,530330322032,"Block Group 2, Census Tract 322.03, King County, Washington",539,92,0,12,0,12,0,12,539,92,58,48,481,108
1500000US530330322033,530330322033,"Block Group 3, Census Tract 322.03, King County, Washington",843,123,0,12,0,12,0,12,843,123,82,60,761,117
1500000US530330322034,530330322034,"Block Group 4, Census Tract 322.03, King County, Washington",430,85,0,12,0,12,0,12,430,85,79,69,351,87
1500000US530330322071,530330322071,"Block Group 1, Census Tract 322.07, King County, Washington",414,55,11,17,0,12,11,17,403,55,79,42,324,73
1500000US530330322072,530330322072,"Block Group 2, Census Tract 322.07, King County, Washington",352,63,0,12,0,12,0,12,352,63,49,30,303,70
1500000US530330322073,530330322073,"Block Group 3, Census Tract 322.07, King County, Washington",461,71,0,12,0,12,0,12,461,71,35,24,426,73
1500000US530330322081,530330322081,"Block Group 1, Census Tract 322.08, King County, Washington",722,129,0,12,0,12,0,12,722,129,206,100,516,109
1500000US530330322082,530330322082,"Block Group 2, Census Tract 322.08, King County, Washington",643,115,12,20,12,20,0,12,631,115,150,65,481,121
1500000US530330322083,530330322083,"Block Group 3, Census Tract 322.08, King County, Washington",926,127,24,37,24,37,0,12,902,127,212,83,690,114
1500000US530330322084,530330322084,"Block Group 4, Census Tract 322.08, King County, Washington",877,141,15,24,0,12,15,24,862,140,15,23,847,137
1500000US530330322085,530330322085,"Block Group 5, Census Tract 322.08, King County, Washington",923,123,40,63,40,63,0,12,883,118,160,68,723,123
1500000US530330322101,530330322101,"Block Group 1, Census Tract 322.10, King County, Washington",573,159,15,28,0,12,15,28,558,160,71,77,487,157
1500000US530330322102,530330322102,"Block Group 2, Census Tract 322.10, King County, Washington",1819,203,27,41,0,17,27,41,1792,201,175,145,1617,204
1500000US530330322103,530330322103,"Block Group 3, Census Tract 322.10, King County, Washington",2314,244,183,185,23,39,160,181,2131,240,157,97,1974,240
1500000US530330322111,530330322111,"Block Group 1, Census Tract 322.11, King County, Washington",584,62,0,12,0,12,0,12,584,62,31,24,553,64
1500000US530330322112,530330322112,"Block Group 2, Census Tract 322.11, King County, Washington",647,70,0,12,0,12,0,12,647,70,67,36,580,81
1500000US530330322113,530330322113,"Block Group 3, Census Tract 322.11, King County, Washington",461,57,10,17,0,12,10,17,451,57,31,22,420,56
1500000US530330322121,530330322121,"Block Group 1, Census Tract 322.12, King County, Washington",867,115,0,12,0,12,0,12,867,115,53,50,814,112
1500000US530330322122,530330322122,"Block Group 2, Census Tract 322.12, King County, Washington",371,95,0,12,0,12,0,12,371,95,0,12,371,95
1500000US530330322123,530330322123,"Block Group 3, Census Tract 322.12, King County, Washington",479,81,0,12,0,12,0,12,479,81,37,55,442,84
1500000US530330322124,530330322124,"Block Group 4, Census Tract 322.12, King County, Washington",1100,138,48,50,0,12,48,50,1052,146,35,39,1017,144
1500000US530330322131,530330322131,"Block Group 1, Census Tract 322.13, King County, Washington",378,56,0,12,0,12,0,12,378,56,60,42,318,61
1500000US530330322132,530330322132,"Block Group 2, Census Tract 322.13, King County, Washington",366,49,0,12,0,12,0,12,366,49,17,19,349,51
1500000US530330322133,530330322133,"Block Group 3, Census Tract 322.13, King County, Washington",752,62,0,12,0,12,0,12,752,62,83,42,669,75
1500000US530330322141,530330322141,"Block Group 1, Census Tract 322.14, King County, Washington",562,62,0,12,0,12,0,12,562,62,54,35,508,65
1500000US530330322142,530330322142,"Block Group 2, Census Tract 322.14, King County, Washington",880,68,17,20,17,20,0,12,863,71,107,60,756,81
1500000US530330322143,530330322143,"Block Group 3, Census Tract 322.14, King County, Washington",559,53,19,21,19,21,0,12,540,55,71,36,469,60
1500000US530330322151,530330322151,"Block Group 1, Census Tract 322.15, King County, Washington",579,80,0,12,0,12,0,12,579,80,42,30,537,90
1500000US530330322152,530330322152,"Block Group 2, Census Tract 322.15, King County, Washington",884,80,10,16,10,16,0,12,874,84,54,30,820,86
1500000US530330323071,530330323071,"Block Group 1, Census Tract 323.07, King County, Washington",606,71,0,12,0,12,0,12,606,71,65,53,541,75
1500000US530330323072,530330323072,"Block Group 2, Census Tract 323.07, King County, Washington",372,73,0,12,0,12,0,12,372,73,21,34,351,75
1500000US530330323073,530330323073,"Block Group 3, Census Tract 323.07, King County, Washington",528,125,0,12,0,12,0,12,528,125,18,28,510,126
1500000US530330323074,530330323074,"Block Group 4, Census Tract 323.07, King County, Washington",421,103,16,25,16,25,0,12,405,102,30,35,375,106
1500000US530330323075,530330323075,"Block Group 5, Census Tract 323.07, King County, Washington",376,104,0,12,0,12,0,12,376,104,60,75,316,96
1500000US530330323091,530330323091,"Block Group 1, Census Tract 323.09, King County, Washington",810,143,0,12,0,12,0,12,810,143,46,42,764,140
1500000US530330323092,530330323092,"Block Group 2, Census Tract 323.09, King County, Washington",1878,192,85,69,69,72,16,25,1793,190,70,50,1723,195
1500000US530330323093,530330323093,"Block Group 3, Census Tract 323.09, King County, Washington",667,89,0,12,0,12,0,12,667,89,0,12,667,89
1500000US530330323111,530330323111,"Block Group 1, Census Tract 323.11, King County, Washington",426,67,0,12,0,12,0,12,426,67,41,38,385,79
1500000US530330323112,530330323112,"Block Group 2, Census Tract 323.11, King County, Washington",496,110,0,12,0,12,0,12,496,110,45,50,451,105
1500000US530330323113,530330323113,"Block Group 3, Census Tract 323.11, King County, Washington",310,59,0,12,0,12,0,12,310,59,69,48,241,64
1500000US530330323114,530330323114,"Block Group 4, Census Tract 323.11, King County, Washington",517,90,0,12,0,12,0,12,517,90,45,41,472,97
1500000US530330323115,530330323115,"Block Group 5, Census Tract 323.11, King County, Washington",380,113,0,12,0,12,0,12,380,113,24,37,356,117
1500000US530330323131,530330323131,"Block Group 1, Census Tract 323.13, King County, Washington",293,77,0,12,0,12,0,12,293,77,48,36,245,67
1500000US530330323132,530330323132,"Block Group 2, Census Tract 323.13, King County, Washington",568,88,23,33,23,33,0,12,545,93,128,54,417,93
1500000US530330323133,530330323133,"Block Group 3, Census Tract 323.13, King County, Washington",239,59,0,12,0,12,0,12,239,59,35,49,204,43
1500000US530330323134,530330323134,"Block Group 4, Census Tract 323.13, King County, Washington",1232,121,90,80,57,72,33,36,1142,148,80,55,1062,151
1500000US530330323151,530330323151,"Block Group 1, Census Tract 323.15, King County, Washington",758,94,10,15,0,12,10,15,748,97,136,48,612,102
1500000US530330323152,530330323152,"Block Group 2, Census Tract 323.15, King County, Washington",610,105,59,64,46,53,13,20,551,107,8,12,543,108
1500000US530330323153,530330323153,"Block Group 3, Census Tract 323.15, King County, Washington",658,96,62,61,5,9,57,61,596,90,38,31,558,91
1500000US530330323161,530330323161,"Block Group 1, Census Tract 323.16, King County, Washington",280,48,5,8,5,8,0,12,275,50,33,27,242,59
1500000US530330323162,530330323162,"Block Group 2, Census Tract 323.16, King County, Washington",539,64,0,12,0,12,0,12,539,64,55,35,484,72
1500000US530330323163,530330323163,"Block Group 3, Census Tract 323.16, King County, Washington",636,78,0,12,0,12,0,12,636,78,65,33,571,82
1500000US530330323164,530330323164,"Block Group 4, Census Tract 323.16, King County, Washington",409,67,0,12,0,12,0,12,409,67,29,24,380,69
1500000US530330323171,530330323171,"Block Group 1, Census Tract 323.17, King County, Washington",531,83,50,59,0,12,50,59,481,80,104,62,377,94
1500000US530330323172,530330323172,"Block Group 2, Census Tract 323.17, King County, Washington",479,73,0,12,0,12,0,12,479,73,32,36,447,75
1500000US530330323173,530330323173,"Block Group 3, Census Tract 323.17, King County, Washington",459,71,47,46,17,27,30,36,412,79,29,26,383,81
1500000US530330323174,530330323174,"Block Group 4, Census Tract 323.17, King County, Washington",315,71,0,12,0,12,0,12,315,71,54,42,261,86
1500000US530330323175,530330323175,"Block Group 5, Census Tract 323.17, King County, Washington",371,63,11,17,0,12,11,17,360,62,52,49,308,60
1500000US530330323181,530330323181,"Block Group 1, Census Tract 323.18, King County, Washington",742,61,0,12,0,12,0,12,742,61,49,35,693,68
1500000US530330323182,530330323182,"Block Group 2, Census Tract 323.18, King County, Washington",390,52,10,15,10,15,0,12,380,52,45,31,335,59
1500000US530330323183,530330323183,"Block Group 3, Census Tract 323.18, King County, Washington",279,48,0,12,0,12,0,12,279,48,47,28,232,51
1500000US530330323184,530330323184,"Block Group 4, Census Tract 323.18, King County, Washington",568,76,13,20,13,20,0,12,555,77,80,50,475,80
1500000US530330323191,530330323191,"Block Group 1, Census Tract 323.19, King County, Washington",219,64,7,15,7,15,0,12,212,66,22,30,190,61
1500000US530330323192,530330323192,"Block Group 2, Census Tract 323.19, King County, Washington",688,121,0,12,0,12,0,12,688,121,70,50,618,127
1500000US530330323193,530330323193,"Block Group 3, Census Tract 323.19, King County, Washington",951,196,152,112,0,12,152,112,799,192,82,54,717,194
1500000US530330323194,530330323194,"Block Group 4, Census Tract 323.19, King County, Washington",637,132,36,38,19,29,17,27,601,136,176,121,425,117
1500000US530330323201,530330323201,"Block Group 1, Census Tract 323.20, King County, Washington",430,65,0,12,0,12,0,12,430,65,97,44,333,70
1500000US530330323202,530330323202,"Block Group 2, Census Tract 323.20, King County, Washington",505,75,26,28,17,25,9,13,479,78,90,66,389,76
1500000US530330323203,530330323203,"Block Group 3, Census Tract 323.20, King County, Washington",605,58,0,12,0,12,0,12,605,58,45,27,560,66
1500000US530330323211,530330323211,"Block Group 1, Census Tract 323.21, King County, Washington",326,44,0,12,0,12,0,12,326,44,65,41,261,52
1500000US530330323212,530330323212,"Block Group 2, Census Tract 323.21, King County, Washington",384,62,0,12,0,12,0,12,384,62,53,36,331,67
1500000US530330323213,530330323213,"Block Group 3, Census Tract 323.21, King County, Washington",633,77,0,12,0,12,0,12,633,77,65,34,568,70
1500000US530330323214,530330323214,"Block Group 4, Census Tract 323.21, King County, Washington",453,61,0,12,0,12,0,12,453,61,8,13,445,62
1500000US530330323221,530330323221,"Block Group 1, Census Tract 323.22, King County, Washington",388,48,9,14,9,14,0,12,379,48,47,34,332,56
1500000US530330323222,530330323222,"Block Group 2, Census Tract 323.22, King County, Washington",286,45,0,12,0,12,0,12,286,45,21,22,265,47
1500000US530330323223,530330323223,"Block Group 3, Census Tract 323.22, King County, Washington",502,60,23,20,0,12,23,20,479,67,67,52,412,70
1500000US530330323231,530330323231,"Block Group 1, Census Tract 323.23, King County, Washington",499,118,0,12,0,12,0,12,499,118,30,40,469,109
1500000US530330323232,530330323232,"Block Group 2, Census Tract 323.23, King County, Washington",708,107,0,12,0,12,0,12,708,107,247,83,461,113
1500000US530330323233,530330323233,"Block Group 3, Census Tract 323.23, King County, Washington",496,97,0,12,0,12,0,12,496,97,77,53,419,108
1500000US530330323234,530330323234,"Block Group 4, Census Tract 323.23, King County, Washington",508,91,0,12,0,12,0,12,508,91,51,44,457,95
1500000US530330323241,530330323241,"Block Group 1, Census Tract 323.24, King County, Washington",319,62,0,12,0,12,0,12,319,62,27,31,292,60
1500000US530330323242,530330323242,"Block Group 2, Census Tract 323.24, King County, Washington",470,116,106,104,54,75,52,78,364,91,91,49,273,96
1500000US530330323243,530330323243,"Block Group 3, Census Tract 323.24, King County, Washington",906,118,96,69,80,65,16,26,810,114,14,23,796,113
1500000US530330323244,530330323244,"Block Group 4, Census Tract 323.24, King County, Washington",523,90,12,21,0,12,12,21,511,92,86,58,425,93
1500000US530330323251,530330323251,"Block Group 1, Census Tract 323.25, King County, Washington",142,47,0,12,0,12,0,12,142,47,38,44,104,57
1500000US530330323252,530330323252,"Block Group 2, Census Tract 323.25, King County, Washington",802,151,92,88,16,26,76,84,710,140,26,29,684,142
1500000US530330323253,530330323253,"Block Group 3, Census Tract 323.25, King County, Washington",1240,172,34,35,34,35,0,12,1206,174,88,79,1118,170
1500000US530330323261,530330323261,"Block Group 1, Census Tract 323.26, King County, Washington",480,48,0,12,0,12,0,12,480,48,44,32,436,57
1500000US530330323262,530330323262,"Block Group 2, Census Tract 323.26, King County, Washington",653,70,38,43,22,35,16,27,615,77,155,64,460,68
1500000US530330323263,530330323263,"Block Group 3, Census Tract 323.26, King County, Washington",286,60,13,21,0,12,13,21,273,64,40,41,233,57
1500000US530330323271,530330323271,"Block Group 1, Census Tract 323.27, King County, Washington",1656,117,29,26,20,21,9,14,1627,118,417,104,1210,139
1500000US530330323272,530330323272,"Block Group 2, Census Tract 323.27, King County, Washington",240,57,0,12,0,12,0,12,240,57,30,21,210,59
1500000US530330323281,530330323281,"Block Group 1, Census Tract 323.28, King County, Washington",467,71,0,12,0,12,0,12,467,71,97,60,370,66
1500000US530330323282,530330323282,"Block Group 2, Census Tract 323.28, King County, Washington",319,55,11,18,0,12,11,18,308,53,38,32,270,61
1500000US530330323283,530330323283,"Block Group 3, Census Tract 323.28, King County, Washington",358,55,0,12,0,12,0,12,358,55,48,35,310,59
1500000US530330323291,530330323291,"Block Group 1, Census Tract 323.29, King County, Washington",1256,108,0,12,0,12,0,12,1256,108,121,67,1135,123
1500000US530330323292,530330323292,"Block Group 2, Census Tract 323.29, King County, Washington",1815,143,55,50,0,12,55,50,1760,144,308,106,1452,166
1500000US530330324011,530330324011,"Block Group 1, Census Tract 324.01, King County, Washington",593,114,34,42,19,33,15,26,559,110,68,50,491,113
1500000US530330324012,530330324012,"Block Group 2, Census Tract 324.01, King County, Washington",702,107,0,12,0,12,0,12,702,107,144,69,558,114
1500000US530330324013,530330324013,"Block Group 3, Census Tract 324.01, King County, Washington",430,114,14,24,14,24,0,12,416,118,19,32,397,120
1500000US530330324014,530330324014,"Block Group 4, Census Tract 324.01, King County, Washington",435,110,13,24,0,12,13,24,422,112,96,90,326,101
1500000US530330324021,530330324021,"Block Group 1, Census Tract 324.02, King County, Washington",740,102,0,12,0,12,0,12,740,102,55,45,685,109
1500000US530330324022,530330324022,"Block Group 2, Census Tract 324.02, King County, Washington",764,98,0,12,0,12,0,12,764,98,32,38,732,97
1500000US530330324023,530330324023,"Block Group 3, Census Tract 324.02, King County, Washington",523,97,0,12,0,12,0,12,523,97,57,53,466,103
1500000US530330324024,530330324024,"Block Group 4, Census Tract 324.02, King County, Washington",313,143,62,74,0,12,62,74,251,126,35,40,216,127
1500000US530330325001,530330325001,"Block Group 1, Census Tract 325, King County, Washington",421,74,20,21,11,16,9,13,401,79,92,41,309,82
1500000US530330325002,530330325002,"Block Group 2, Census Tract 325, King County, Washington",616,80,11,16,11,16,0,12,605,82,92,57,513,84
1500000US530330325003,530330325003,"Block Group 3, Census Tract 325, King County, Washington",385,76,41,26,14,11,27,23,344,72,107,54,237,64
1500000US530330325004,530330325004,"Block Group 4, Census Tract 325, King County, Washington",565,93,19,13,8,9,11,9,546,94,90,41,456,102
1500000US530330326011,530330326011,"Block Group 1, Census Tract 326.01, King County, Washington",722,93,52,48,13,20,39,44,670,95,111,52,559,105
1500000US530330326012,530330326012,"Block Group 2, Census Tract 326.01, King County, Washington",368,67,25,39,0,12,25,39,343,63,42,27,301,65
1500000US530330326021,530330326021,"Block Group 1, Census Tract 326.02, King County, Washington",1067,142,44,35,19,30,25,20,1023,143,178,92,845,156
1500000US530330326022,530330326022,"Block Group 2, Census Tract 326.02, King County, Washington",403,106,13,20,13,20,0,12,390,106,78,58,312,106
1500000US530330326023,530330326023,"Block Group 3, Census Tract 326.02, King County, Washington",1447,142,45,72,0,12,45,72,1402,142,250,95,1152,142
1500000US530330326024,530330326024,"Block Group 4, Census Tract 326.02, King County, Washington",1164,114,62,77,0,12,62,77,1102,126,97,64,1005,136
1500000US530330327021,530330327021,"Block Group 1, Census Tract 327.02, King County, Washington",625,90,16,25,0,12,16,25,609,92,61,51,548,96
1500000US530330327022,530330327022,"Block Group 2, Census Tract 327.02, King County, Washington",469,91,0,12,0,12,0,12,469,91,28,23,441,98
1500000US530330327023,530330327023,"Block Group 3, Census Tract 327.02, King County, Washington",346,93,16,25,0,12,16,25,330,90,62,46,268,96
1500000US530330327024,530330327024,"Block Group 4, Census Tract 327.02, King County, Washington",358,104,15,24,0,12,15,24,343,102,67,71,276,111
1500000US530330327025,530330327025,"Block Group 5, Census Tract 327.02, King County, Washington",432,109,17,27,0,12,17,27,415,108,81,53,334,117
1500000US530330327026,530330327026,"Block Group 6, Census Tract 327.02, King County, Washington",279,71,0,12,0,12,0,12,279,71,60,51,219,67
1500000US530330327031,530330327031,"Block Group 1, Census Tract 327.03, King County, Washington",546,75,50,36,44,36,6,9,496,69,76,46,420,71
1500000US530330327032,530330327032,"Block Group 2, Census Tract 327.03, King County, Washington",307,69,37,32,10,16,27,30,270,59,24,17,246,59
1500000US530330327041,530330327041,"Block Group 1, Census Tract 327.04, King County, Washington",615,126,52,46,52,46,0,12,563,119,163,82,400,106
1500000US530330327042,530330327042,"Block Group 2, Census Tract 327.04, King County, Washington",681,110,56,83,0,12,56,83,625,118,117,84,508,103
1500000US530330327043,530330327043,"Block Group 3, Census Tract 327.04, King County, Washington",515,97,48,49,38,46,10,18,467,104,78,48,389,106
1500000US530330327044,530330327044,"Block Group 4, Census Tract 327.04, King County, Washington",633,132,248,123,92,87,156,113,385,131,103,88,282,112
1500000US530330328001,530330328001,"Block Group 1, Census Tract 328, King County, Washington",276,67,10,14,0,12,10,14,266,66,21,21,245,67
1500000US530330328002,530330328002,"Block Group 2, Census Tract 328, King County, Washington",476,58,0,12,0,12,0,12,476,58,84,41,392,66
1500000US530330328003,530330328003,"Block Group 3, Census Tract 328, King County, Washington",234,53,48,27,37,24,11,14,186,49,54,27,132,43
1500000US530339901000,530339901000,"Block Group 0, Census Tract 9901, King County, Washington",0,12,0,12,0,12,0,12,0,12,0,12,0,12
