Id,Id2,Geography,Food Stamps Total,Margin of Error; Total:,Estimate; Household received Food Stamps/SNAP in the past 12 months:,Margin of Error; Household received Food Stamps/SNAP in the past 12 months:,Estimate; Household received Food Stamps/SNAP in the past 12 months: - Households with 1 or more persons with a disability,Margin of Error; Household received Food Stamps/SNAP in the past 12 months: - Households with 1 or more persons with a disability,Estimate; Household received Food Stamps/SNAP in the past 12 months: - Households with no persons with a disability,Margin of Error; Household received Food Stamps/SNAP in the past 12 months: - Households with no persons with a disability,Estimate; Household did not receive Food Stamps/SNAP in the past 12 months:,Margin of Error; Household did not receive Food Stamps/SNAP in the past 12 months:,Estimate; Household did not receive Food Stamps/SNAP in the past 12 months: - Households with 1 or more persons with a disability,Margin of Error; Household did not receive Food Stamps/SNAP in the past 12 months: - Households with 1 or more persons with a disability,Estimate; Household did not receive Food Stamps/SNAP in the past 12 months: - Households with no persons with a disability,Margin of Error; Household did not receive Food Stamps/SNAP in the past 12 months: - Households with no persons with a disability
1500000US530330001001,530330001001,"Block Group 1, Census Tract 1, King County, Washington",531,128,36,36,0,12,36,36,495,128,109,63,386,120
1500000US530330001002,530330001002,"Block Group 2, Census Tract 1, King County, Washington",600,128,97,83,34,56,63,63,503,127,73,46,430,130
1500000US530330001003,530330001003,"Block Group 3, Census Tract 1, King County, Washington",705,119,147,72,116,63,31,35,558,131,159,109,399,108
1500000US530330001004,530330001004,"Block Group 4, Census Tract 1, King County, Washington",782,161,249,99,81,64,168,76,533,142,53,43,480,139
1500000US530330001005,530330001005,"Block Group 5, Census Tract 1, King County, Washington",564,108,46,42,31,36,15,23,518,110,68,47,450,109
1500000US530330002001,530330002001,"Block Group 1, Census Tract 2, King County, Washington",454,81,34,28,34,28,0,12,420,78,16,25,404,79
1500000US530330002002,530330002002,"Block Group 2, Census Tract 2, King County, Washington",467,121,66,85,0,12,66,85,401,125,62,48,339,127
1500000US530330002003,530330002003,"Block Group 3, Census Tract 2, King County, Washington",855,143,36,41,17,26,19,32,819,150,70,62,749,155
1500000US530330002004,530330002004,"Block Group 4, Census Tract 2, King County, Washington",529,97,33,38,21,32,12,20,496,99,99,50,397,99
1500000US530330002005,530330002005,"Block Group 5, Census Tract 2, King County, Washington",791,150,191,122,40,44,151,113,600,142,179,98,421,141
1500000US530330002006,530330002006,"Block Group 6, Census Tract 2, King County, Washington",477,103,14,22,14,22,0,12,463,104,87,58,376,101
1500000US530330003001,530330003001,"Block Group 1, Census Tract 3, King County, Washington",508,65,70,60,17,21,53,57,438,71,74,40,364,71
1500000US530330003002,530330003002,"Block Group 2, Census Tract 3, King County, Washington",569,76,150,89,69,68,81,63,419,79,58,37,361,77
1500000US530330004011,530330004011,"Block Group 1, Census Tract 4.01, King County, Washington",1648,238,430,142,231,119,199,102,1218,225,262,89,956,211
1500000US530330004012,530330004012,"Block Group 2, Census Tract 4.01, King County, Washington",699,153,0,12,0,12,0,12,699,153,63,45,636,154
1500000US530330004013,530330004013,"Block Group 3, Census Tract 4.01, King County, Washington",814,136,155,74,89,60,66,51,659,142,322,117,337,110
1500000US530330004021,530330004021,"Block Group 1, Census Tract 4.02, King County, Washington",503,133,86,87,36,38,50,79,417,115,70,85,347,86
1500000US530330004022,530330004022,"Block Group 2, Census Tract 4.02, King County, Washington",486,102,0,12,0,12,0,12,486,102,68,51,418,110
1500000US530330004023,530330004023,"Block Group 3, Census Tract 4.02, King County, Washington",608,134,39,44,23,35,16,25,569,138,44,41,525,142
1500000US530330004024,530330004024,"Block Group 4, Census Tract 4.02, King County, Washington",763,136,16,20,16,20,0,12,747,135,338,108,409,109
1500000US530330005001,530330005001,"Block Group 1, Census Tract 5, King County, Washington",447,56,0,12,0,12,0,12,447,56,122,53,325,67
1500000US530330005002,530330005002,"Block Group 2, Census Tract 5, King County, Washington",355,61,0,12,0,12,0,12,355,61,60,34,295,69
1500000US530330005003,530330005003,"Block Group 3, Census Tract 5, King County, Washington",467,69,11,18,11,18,0,12,456,71,100,38,356,77
1500000US530330006001,530330006001,"Block Group 1, Census Tract 6, King County, Washington",523,155,21,22,10,15,11,17,502,162,80,53,422,155
1500000US530330006002,530330006002,"Block Group 2, Census Tract 6, King County, Washington",615,156,120,87,54,87,66,88,495,136,155,112,340,106
1500000US530330006003,530330006003,"Block Group 3, Census Tract 6, King County, Washington",576,124,30,34,0,12,30,34,546,131,39,38,507,135
1500000US530330006004,530330006004,"Block Group 4, Census Tract 6, King County, Washington",689,152,41,43,32,38,9,21,648,153,64,47,584,163
1500000US530330006005,530330006005,"Block Group 5, Census Tract 6, King County, Washington",232,58,5,13,0,12,5,13,227,57,51,39,176,68
1500000US530330006006,530330006006,"Block Group 6, Census Tract 6, King County, Washington",736,154,82,57,47,41,35,40,654,158,74,68,580,155
1500000US530330007001,530330007001,"Block Group 1, Census Tract 7, King County, Washington",926,149,130,71,14,21,116,68,796,159,68,47,728,161
1500000US530330007002,530330007002,"Block Group 2, Census Tract 7, King County, Washington",489,103,82,72,53,63,29,34,407,101,71,61,336,89
1500000US530330007003,530330007003,"Block Group 3, Census Tract 7, King County, Washington",399,100,70,62,0,12,70,62,329,90,17,26,312,89
1500000US530330007004,530330007004,"Block Group 4, Census Tract 7, King County, Washington",289,67,17,27,17,27,0,12,272,64,36,33,236,62
1500000US530330008001,530330008001,"Block Group 1, Census Tract 8, King County, Washington",463,65,14,19,0,12,14,19,449,62,77,40,372,69
1500000US530330008002,530330008002,"Block Group 2, Census Tract 8, King County, Washington",572,71,71,48,9,14,62,45,501,67,47,32,454,74
1500000US530330009001,530330009001,"Block Group 1, Census Tract 9, King County, Washington",545,58,29,24,4,7,25,23,516,61,103,45,413,67
1500000US530330009002,530330009002,"Block Group 2, Census Tract 9, King County, Washington",346,49,12,17,0,12,12,17,334,51,11,12,323,52
1500000US530330010001,530330010001,"Block Group 1, Census Tract 10, King County, Washington",294,63,67,40,27,25,40,34,227,59,8,9,219,59
1500000US530330010002,530330010002,"Block Group 2, Census Tract 10, King County, Washington",441,59,23,26,3,7,20,24,418,61,22,15,396,63
1500000US530330011001,530330011001,"Block Group 1, Census Tract 11, King County, Washington",471,78,13,20,13,20,0,12,458,77,146,68,312,69
1500000US530330011002,530330011002,"Block Group 2, Census Tract 11, King County, Washington",627,80,62,45,26,31,36,29,565,83,86,49,479,94
1500000US530330012001,530330012001,"Block Group 1, Census Tract 12, King County, Washington",524,106,80,81,17,28,63,76,444,111,72,66,372,118
1500000US530330012002,530330012002,"Block Group 2, Census Tract 12, King County, Washington",581,148,0,12,0,12,0,12,581,148,0,12,581,148
1500000US530330012003,530330012003,"Block Group 3, Census Tract 12, King County, Washington",982,176,98,61,47,46,51,40,884,178,289,108,595,173
1500000US530330012004,530330012004,"Block Group 4, Census Tract 12, King County, Washington",610,159,114,109,51,43,63,100,496,165,104,61,392,160
1500000US530330012005,530330012005,"Block Group 5, Census Tract 12, King County, Washington",881,190,81,52,39,40,42,35,800,199,154,114,646,179
1500000US530330013001,530330013001,"Block Group 1, Census Tract 13, King County, Washington",819,103,91,68,40,42,51,49,728,108,111,61,617,121
1500000US530330013002,530330013002,"Block Group 2, Census Tract 13, King County, Washington",658,106,152,83,56,48,96,70,506,125,89,87,417,115
1500000US530330013003,530330013003,"Block Group 3, Census Tract 13, King County, Washington",665,146,42,41,0,12,42,41,623,146,51,49,572,145
1500000US530330014001,530330014001,"Block Group 1, Census Tract 14, King County, Washington",567,101,58,63,19,29,39,60,509,96,52,41,457,97
1500000US530330014002,530330014002,"Block Group 2, Census Tract 14, King County, Washington",347,93,7,14,0,12,7,14,340,92,74,55,266,79
1500000US530330014003,530330014003,"Block Group 3, Census Tract 14, King County, Washington",614,113,24,28,12,19,12,19,590,111,38,34,552,108
1500000US530330014004,530330014004,"Block Group 4, Census Tract 14, King County, Washington",586,95,38,59,0,12,38,59,548,89,60,42,488,96
1500000US530330015001,530330015001,"Block Group 1, Census Tract 15, King County, Washington",550,49,15,16,8,12,7,11,535,53,50,37,485,64
1500000US530330015002,530330015002,"Block Group 2, Census Tract 15, King County, Washington",565,58,7,11,0,12,7,11,558,60,121,63,437,70
1500000US530330016001,530330016001,"Block Group 1, Census Tract 16, King County, Washington",507,49,0,12,0,12,0,12,507,49,81,40,426,55
1500000US530330016002,530330016002,"Block Group 2, Census Tract 16, King County, Washington",544,62,10,16,0,12,10,16,534,66,44,35,490,68
1500000US530330016003,530330016003,"Block Group 3, Census Tract 16, King County, Washington",735,80,9,14,9,14,0,12,726,81,87,45,639,73
1500000US530330017011,530330017011,"Block Group 1, Census Tract 17.01, King County, Washington",913,123,62,53,48,57,14,23,851,118,76,51,775,123
1500000US530330017012,530330017012,"Block Group 2, Census Tract 17.01, King County, Washington",509,87,27,43,0,12,27,43,482,83,54,37,428,88
1500000US530330017013,530330017013,"Block Group 3, Census Tract 17.01, King County, Washington",542,85,8,14,1,8,7,11,534,86,80,47,454,98
1500000US530330017021,530330017021,"Block Group 1, Census Tract 17.02, King County, Washington",765,107,176,88,107,64,69,61,589,104,58,39,531,109
1500000US530330017022,530330017022,"Block Group 2, Census Tract 17.02, King County, Washington",476,89,47,35,36,31,11,17,429,90,113,56,316,85
1500000US530330017023,530330017023,"Block Group 3, Census Tract 17.02, King County, Washington",376,72,57,44,29,29,28,35,319,76,42,35,277,73
1500000US530330017024,530330017024,"Block Group 4, Census Tract 17.02, King County, Washington",266,70,33,39,33,39,0,12,233,67,40,33,193,63
1500000US530330018001,530330018001,"Block Group 1, Census Tract 18, King County, Washington",706,130,61,79,0,12,61,79,645,125,120,63,525,135
1500000US530330018002,530330018002,"Block Group 2, Census Tract 18, King County, Washington",829,127,62,52,26,31,36,42,767,130,0,12,767,130
1500000US530330018003,530330018003,"Block Group 3, Census Tract 18, King County, Washington",711,168,44,47,3,10,41,48,667,163,75,79,592,163
1500000US530330019001,530330019001,"Block Group 1, Census Tract 19, King County, Washington",1061,106,42,41,9,14,33,39,1019,111,146,64,873,125
1500000US530330019002,530330019002,"Block Group 2, Census Tract 19, King County, Washington",566,71,41,42,0,12,41,42,525,67,42,31,483,65
1500000US530330019003,530330019003,"Block Group 3, Census Tract 19, King County, Washington",442,84,20,18,10,12,10,17,422,85,114,51,308,86
1500000US530330020001,530330020001,"Block Group 1, Census Tract 20, King County, Washington",686,86,41,46,41,46,0,12,645,84,134,71,511,77
1500000US530330020002,530330020002,"Block Group 2, Census Tract 20, King County, Washington",522,75,11,17,0,12,11,17,511,77,78,49,433,80
1500000US530330020003,530330020003,"Block Group 3, Census Tract 20, King County, Washington",377,53,10,17,0,12,10,17,367,56,47,29,320,65
1500000US530330021001,530330021001,"Block Group 1, Census Tract 21, King County, Washington",558,71,9,14,0,12,9,14,549,70,101,49,448,73
1500000US530330021002,530330021002,"Block Group 2, Census Tract 21, King County, Washington",392,63,23,33,0,12,23,33,369,62,26,24,343,64
1500000US530330021003,530330021003,"Block Group 3, Census Tract 21, King County, Washington",673,79,19,21,9,14,10,14,654,80,75,52,579,80
1500000US530330022001,530330022001,"Block Group 1, Census Tract 22, King County, Washington",567,70,0,12,0,12,0,12,567,70,46,37,521,81
1500000US530330022002,530330022002,"Block Group 2, Census Tract 22, King County, Washington",578,83,12,21,0,12,12,21,566,83,113,62,453,103
1500000US530330022003,530330022003,"Block Group 3, Census Tract 22, King County, Washington",551,79,0,12,0,12,0,12,551,79,78,50,473,94
1500000US530330022004,530330022004,"Block Group 4, Census Tract 22, King County, Washington",491,80,16,24,0,12,16,24,475,86,63,51,412,92
1500000US530330024001,530330024001,"Block Group 1, Census Tract 24, King County, Washington",375,48,0,12,0,12,0,12,375,48,57,35,318,59
1500000US530330024002,530330024002,"Block Group 2, Census Tract 24, King County, Washington",343,55,13,16,7,12,6,11,330,53,45,30,285,61
1500000US530330024003,530330024003,"Block Group 3, Census Tract 24, King County, Washington",520,71,0,12,0,12,0,12,520,71,77,37,443,79
1500000US530330025001,530330025001,"Block Group 1, Census Tract 25, King County, Washington",581,62,0,12,0,12,0,12,581,62,61,32,520,67
1500000US530330025002,530330025002,"Block Group 2, Census Tract 25, King County, Washington",657,63,34,24,16,13,18,20,623,68,50,38,573,68
1500000US530330026001,530330026001,"Block Group 1, Census Tract 26, King County, Washington",491,81,19,22,8,12,11,19,472,83,21,23,451,81
1500000US530330026002,530330026002,"Block Group 2, Census Tract 26, King County, Washington",575,87,10,16,0,12,10,16,565,92,50,34,515,95
1500000US530330026003,530330026003,"Block Group 3, Census Tract 26, King County, Washington",503,75,0,12,0,12,0,12,503,75,32,23,471,71
1500000US530330026004,530330026004,"Block Group 4, Census Tract 26, King County, Washington",378,54,18,19,10,15,8,13,360,59,59,55,301,56
1500000US530330027001,530330027001,"Block Group 1, Census Tract 27, King County, Washington",635,133,11,18,0,12,11,18,624,136,9,16,615,137
1500000US530330027002,530330027002,"Block Group 2, Census Tract 27, King County, Washington",454,82,20,30,20,30,0,12,434,85,21,24,413,89
1500000US530330027003,530330027003,"Block Group 3, Census Tract 27, King County, Washington",446,100,17,29,17,29,0,12,429,100,44,42,385,100
1500000US530330027004,530330027004,"Block Group 4, Census Tract 27, King County, Washington",634,108,11,19,11,19,0,12,623,110,51,37,572,122
1500000US530330028001,530330028001,"Block Group 1, Census Tract 28, King County, Washington",415,90,0,12,0,12,0,12,415,90,16,27,399,94
1500000US530330028002,530330028002,"Block Group 2, Census Tract 28, King County, Washington",394,84,0,12,0,12,0,12,394,84,51,51,343,83
1500000US530330028003,530330028003,"Block Group 3, Census Tract 28, King County, Washington",561,110,13,22,0,12,13,22,548,109,28,31,520,112
1500000US530330028004,530330028004,"Block Group 4, Census Tract 28, King County, Washington",613,96,24,38,24,38,0,12,589,98,87,59,502,104
1500000US530330029001,530330029001,"Block Group 1, Census Tract 29, King County, Washington",637,82,60,41,7,11,53,40,577,87,65,34,512,89
1500000US530330029002,530330029002,"Block Group 2, Census Tract 29, King County, Washington",597,82,50,41,25,38,25,40,547,77,47,33,500,87
1500000US530330029003,530330029003,"Block Group 3, Census Tract 29, King County, Washington",560,68,8,13,0,12,8,13,552,67,30,20,522,69
1500000US530330030001,530330030001,"Block Group 1, Census Tract 30, King County, Washington",648,76,0,12,0,12,0,12,648,76,102,61,546,90
1500000US530330030002,530330030002,"Block Group 2, Census Tract 30, King County, Washington",609,95,0,12,0,12,0,12,609,95,66,55,543,105
1500000US530330030003,530330030003,"Block Group 3, Census Tract 30, King County, Washington",664,107,0,12,0,12,0,12,664,107,34,34,630,108
1500000US530330030004,530330030004,"Block Group 4, Census Tract 30, King County, Washington",539,99,0,12,0,12,0,12,539,99,78,73,461,97
1500000US530330031001,530330031001,"Block Group 1, Census Tract 31, King County, Washington",531,84,0,12,0,12,0,12,531,84,68,47,463,97
1500000US530330031002,530330031002,"Block Group 2, Census Tract 31, King County, Washington",430,72,24,29,0,12,24,29,406,75,31,34,375,77
1500000US530330031003,530330031003,"Block Group 3, Census Tract 31, King County, Washington",479,108,91,66,83,67,8,14,388,87,33,37,355,77
1500000US530330031004,530330031004,"Block Group 4, Census Tract 31, King County, Washington",631,94,8,15,8,15,0,12,623,100,46,43,577,113
1500000US530330031005,530330031005,"Block Group 5, Census Tract 31, King County, Washington",445,73,24,27,0,12,24,27,421,80,39,34,382,77
1500000US530330032001,530330032001,"Block Group 1, Census Tract 32, King County, Washington",434,102,16,25,0,12,16,25,418,99,26,20,392,100
1500000US530330032002,530330032002,"Block Group 2, Census Tract 32, King County, Washington",761,138,33,36,17,26,16,25,728,137,110,87,618,151
1500000US530330032003,530330032003,"Block Group 3, Census Tract 32, King County, Washington",636,121,38,44,38,44,0,12,598,119,27,30,571,122
1500000US530330032004,530330032004,"Block Group 4, Census Tract 32, King County, Washington",678,146,63,46,14,23,49,46,615,147,77,56,538,148
1500000US530330032005,530330032005,"Block Group 5, Census Tract 32, King County, Washington",274,57,0,12,0,12,0,12,274,57,14,22,260,54
1500000US530330032006,530330032006,"Block Group 6, Census Tract 32, King County, Washington",771,157,71,95,0,12,71,95,700,159,181,89,519,155
1500000US530330032007,530330032007,"Block Group 7, Census Tract 32, King County, Washington",420,96,0,12,0,12,0,12,420,96,79,46,341,100
1500000US530330033001,530330033001,"Block Group 1, Census Tract 33, King County, Washington",564,87,37,42,20,36,17,22,527,90,35,29,492,99
1500000US530330033002,530330033002,"Block Group 2, Census Tract 33, King County, Washington",444,104,0,12,0,12,0,12,444,104,77,63,367,101
1500000US530330033003,530330033003,"Block Group 3, Census Tract 33, King County, Washington",1080,130,121,75,0,12,121,75,959,144,32,32,927,146
1500000US530330033004,530330033004,"Block Group 4, Census Tract 33, King County, Washington",531,87,35,35,0,12,35,35,496,88,28,32,468,88
1500000US530330033005,530330033005,"Block Group 5, Census Tract 33, King County, Washington",564,88,24,29,0,12,24,29,540,93,62,58,478,108
1500000US530330034001,530330034001,"Block Group 1, Census Tract 34, King County, Washington",469,69,9,15,0,12,9,15,460,71,63,55,397,69
1500000US530330034002,530330034002,"Block Group 2, Census Tract 34, King County, Washington",559,92,0,12,0,12,0,12,559,92,25,25,534,97
1500000US530330034003,530330034003,"Block Group 3, Census Tract 34, King County, Washington",400,76,17,20,9,14,8,13,383,76,47,35,336,79
1500000US530330035001,530330035001,"Block Group 1, Census Tract 35, King County, Washington",628,84,54,41,44,38,10,16,574,97,47,38,527,97
1500000US530330035002,530330035002,"Block Group 2, Census Tract 35, King County, Washington",670,95,0,12,0,12,0,12,670,95,68,45,602,105
1500000US530330035003,530330035003,"Block Group 3, Census Tract 35, King County, Washington",540,88,0,12,0,12,0,12,540,88,77,51,463,77
1500000US530330036001,530330036001,"Block Group 1, Census Tract 36, King County, Washington",666,119,21,26,0,12,21,26,645,120,64,52,581,122
1500000US530330036002,530330036002,"Block Group 2, Census Tract 36, King County, Washington",935,164,69,54,54,50,15,24,866,174,52,42,814,173
1500000US530330036003,530330036003,"Block Group 3, Census Tract 36, King County, Washington",556,74,48,27,17,26,31,34,508,78,64,52,444,85
1500000US530330036004,530330036004,"Block Group 4, Census Tract 36, King County, Washington",1093,148,14,22,14,22,0,12,1079,148,160,97,919,155
1500000US530330038001,530330038001,"Block Group 1, Census Tract 38, King County, Washington",463,53,5,8,5,8,0,12,458,54,125,54,333,60
1500000US530330038002,530330038002,"Block Group 2, Census Tract 38, King County, Washington",412,51,6,9,0,12,6,9,406,53,51,30,355,54
1500000US530330039001,530330039001,"Block Group 1, Census Tract 39, King County, Washington",776,65,16,26,0,12,16,26,760,67,91,52,669,77
1500000US530330039002,530330039002,"Block Group 2, Census Tract 39, King County, Washington",421,60,0,12,0,12,0,12,421,60,78,45,343,66
1500000US530330040001,530330040001,"Block Group 1, Census Tract 40, King County, Washington",998,62,161,78,48,39,113,73,837,84,69,36,768,91
1500000US530330040002,530330040002,"Block Group 2, Census Tract 40, King County, Washington",326,53,19,21,9,14,10,15,307,57,44,29,263,56
1500000US530330041001,530330041001,"Block Group 1, Census Tract 41, King County, Washington",560,106,0,12,0,12,0,12,560,106,0,12,560,106
1500000US530330041002,530330041002,"Block Group 2, Census Tract 41, King County, Washington",647,104,0,12,0,12,0,12,647,104,150,79,497,102
1500000US530330041003,530330041003,"Block Group 3, Census Tract 41, King County, Washington",554,95,28,41,28,41,0,12,526,100,27,22,499,108
1500000US530330041004,530330041004,"Block Group 4, Census Tract 41, King County, Washington",596,110,15,24,0,12,15,24,581,113,54,52,527,106
1500000US530330041005,530330041005,"Block Group 5, Census Tract 41, King County, Washington",406,82,23,25,0,12,23,25,383,84,50,44,333,86
1500000US530330041006,530330041006,"Block Group 6, Census Tract 41, King County, Washington",322,82,0,12,0,12,0,12,322,82,73,63,249,77
1500000US530330042001,530330042001,"Block Group 1, Census Tract 42, King County, Washington",707,93,48,76,0,12,48,76,659,87,46,41,613,93
1500000US530330042002,530330042002,"Block Group 2, Census Tract 42, King County, Washington",642,80,55,34,30,34,25,30,587,77,108,61,479,94
1500000US530330042003,530330042003,"Block Group 3, Census Tract 42, King County, Washington",589,102,12,20,0,12,12,20,577,103,38,35,539,104
1500000US530330042004,530330042004,"Block Group 4, Census Tract 42, King County, Washington",692,98,14,26,0,12,14,26,678,102,25,30,653,108
1500000US530330042005,530330042005,"Block Group 5, Census Tract 42, King County, Washington",534,63,11,17,0,12,11,17,523,66,0,12,523,66
1500000US530330043011,530330043011,"Block Group 1, Census Tract 43.01, King County, Washington",446,87,19,23,11,18,8,15,427,88,20,22,407,88
1500000US530330043012,530330043012,"Block Group 2, Census Tract 43.01, King County, Washington",487,81,10,16,10,16,0,12,477,84,35,41,442,87
1500000US530330043013,530330043013,"Block Group 3, Census Tract 43.01, King County, Washington",504,75,27,29,14,21,13,19,477,76,68,42,409,77
1500000US530330043021,530330043021,"Block Group 1, Census Tract 43.02, King County, Washington",557,125,52,69,0,12,52,69,505,126,8,12,497,126
1500000US530330043022,530330043022,"Block Group 2, Census Tract 43.02, King County, Washington",828,149,118,83,31,27,87,79,710,144,155,94,555,141
1500000US530330044001,530330044001,"Block Group 1, Census Tract 44, King County, Washington",561,119,20,33,0,12,20,33,541,117,30,40,511,117
1500000US530330044002,530330044002,"Block Group 2, Census Tract 44, King County, Washington",764,159,13,21,0,12,13,21,751,163,88,57,663,166
1500000US530330044003,530330044003,"Block Group 3, Census Tract 44, King County, Washington",249,89,17,27,17,27,0,12,232,89,0,12,232,89
1500000US530330044004,530330044004,"Block Group 4, Census Tract 44, King County, Washington",780,161,34,38,19,30,15,24,746,159,64,82,682,157
1500000US530330045001,530330045001,"Block Group 1, Census Tract 45, King County, Washington",394,60,41,51,0,12,41,51,353,58,44,28,309,53
1500000US530330045002,530330045002,"Block Group 2, Census Tract 45, King County, Washington",598,71,29,21,0,12,29,21,569,73,78,36,491,75
1500000US530330046001,530330046001,"Block Group 1, Census Tract 46, King County, Washington",438,80,0,12,0,12,0,12,438,80,43,47,395,81
1500000US530330046002,530330046002,"Block Group 2, Census Tract 46, King County, Washington",610,74,21,30,0,12,21,30,589,73,18,19,571,76
1500000US530330046003,530330046003,"Block Group 3, Census Tract 46, King County, Washington",384,61,0,12,0,12,0,12,384,61,120,68,264,56
1500000US530330047001,530330047001,"Block Group 1, Census Tract 47, King County, Washington",487,130,0,12,0,12,0,12,487,130,63,61,424,127
1500000US530330047002,530330047002,"Block Group 2, Census Tract 47, King County, Washington",769,190,0,12,0,12,0,12,769,190,32,38,737,193
1500000US530330047003,530330047003,"Block Group 3, Census Tract 47, King County, Washington",1379,222,93,65,55,42,38,46,1286,218,137,102,1149,208
1500000US530330047004,530330047004,"Block Group 4, Census Tract 47, King County, Washington",1746,269,47,49,0,12,47,49,1699,274,258,165,1441,243
1500000US530330048001,530330048001,"Block Group 1, Census Tract 48, King County, Washington",458,109,15,23,15,23,0,12,443,110,10,17,433,110
1500000US530330048002,530330048002,"Block Group 2, Census Tract 48, King County, Washington",598,122,12,21,0,12,12,21,586,123,58,75,528,111
1500000US530330048003,530330048003,"Block Group 3, Census Tract 48, King County, Washington",587,114,29,34,0,12,29,34,558,112,42,40,516,119
1500000US530330048004,530330048004,"Block Group 4, Census Tract 48, King County, Washington",544,125,0,12,0,12,0,12,544,125,25,30,519,129
1500000US530330049001,530330049001,"Block Group 1, Census Tract 49, King County, Washington",566,104,104,84,25,29,79,83,462,87,33,29,429,97
1500000US530330049002,530330049002,"Block Group 2, Census Tract 49, King County, Washington",546,124,66,62,0,12,66,62,480,125,0,12,480,125
1500000US530330049003,530330049003,"Block Group 3, Census Tract 49, King County, Washington",725,119,19,31,0,12,19,31,706,123,0,12,706,123
1500000US530330049004,530330049004,"Block Group 4, Census Tract 49, King County, Washington",845,133,19,28,0,12,19,28,826,136,18,29,808,137
1500000US530330049005,530330049005,"Block Group 5, Census Tract 49, King County, Washington",960,172,46,44,14,22,32,38,914,179,27,29,887,182
1500000US530330050001,530330050001,"Block Group 1, Census Tract 50, King County, Washington",674,81,15,16,7,11,8,13,659,83,41,42,618,92
1500000US530330050002,530330050002,"Block Group 2, Census Tract 50, King County, Washington",418,90,0,12,0,12,0,12,418,90,8,13,410,91
1500000US530330050003,530330050003,"Block Group 3, Census Tract 50, King County, Washington",741,104,69,64,51,62,18,19,672,95,167,69,505,101
1500000US530330051001,530330051001,"Block Group 1, Census Tract 51, King County, Washington",692,84,10,14,10,14,0,12,682,86,60,48,622,89
1500000US530330051002,530330051002,"Block Group 2, Census Tract 51, King County, Washington",528,59,8,12,8,12,0,12,520,59,81,36,439,67
1500000US530330051003,530330051003,"Block Group 3, Census Tract 51, King County, Washington",378,55,7,13,0,12,7,13,371,53,28,25,343,53
1500000US530330052001,530330052001,"Block Group 1, Census Tract 52, King County, Washington",511,124,75,79,14,22,61,76,436,111,50,43,386,116
1500000US530330052002,530330052002,"Block Group 2, Census Tract 52, King County, Washington",619,145,29,35,16,28,13,21,590,152,17,27,573,155
1500000US530330052003,530330052003,"Block Group 3, Census Tract 52, King County, Washington",555,98,29,34,13,21,16,26,526,111,50,51,476,116
1500000US530330052004,530330052004,"Block Group 4, Census Tract 52, King County, Washington",532,96,47,77,0,12,47,77,485,81,87,51,398,92
1500000US530330052005,530330052005,"Block Group 5, Census Tract 52, King County, Washington",687,153,124,84,81,78,43,37,563,141,83,82,480,129
1500000US530330053011,530330053011,"Block Group 1, Census Tract 53.01, King County, Washington",338,118,9,15,9,15,0,12,329,117,43,59,286,114
1500000US530330053012,530330053012,"Block Group 2, Census Tract 53.01, King County, Washington",1157,165,83,42,59,42,24,31,1074,165,105,101,969,164
1500000US530330053013,530330053013,"Block Group 3, Census Tract 53.01, King County, Washington",671,134,71,77,71,77,0,12,600,133,39,43,561,127
1500000US530330053014,530330053014,"Block Group 4, Census Tract 53.01, King County, Washington",526,140,43,69,0,12,43,69,483,123,80,64,403,103
1500000US530330053021,530330053021,"Block Group 1, Census Tract 53.02, King County, Washington",128,32,0,12,0,12,0,12,128,32,0,12,128,32
1500000US530330053022,530330053022,"Block Group 2, Census Tract 53.02, King County, Washington",14,15,0,12,0,12,0,12,14,15,0,12,14,15
1500000US530330053023,530330053023,"Block Group 3, Census Tract 53.02, King County, Washington",0,12,0,12,0,12,0,12,0,12,0,12,0,12
1500000US530330054001,530330054001,"Block Group 1, Census Tract 54, King County, Washington",369,78,8,15,8,15,0,12,361,81,34,46,327,81
1500000US530330054002,530330054002,"Block Group 2, Census Tract 54, King County, Washington",779,129,62,67,0,12,62,67,717,127,14,21,703,127
1500000US530330054003,530330054003,"Block Group 3, Census Tract 54, King County, Washington",735,122,50,81,0,12,50,81,685,113,106,65,579,114
1500000US530330054004,530330054004,"Block Group 4, Census Tract 54, King County, Washington",804,118,14,23,0,12,14,23,790,120,23,29,767,126
1500000US530330056001,530330056001,"Block Group 1, Census Tract 56, King County, Washington",545,67,0,12,0,12,0,12,545,67,43,40,502,75
1500000US530330056002,530330056002,"Block Group 2, Census Tract 56, King County, Washington",597,96,0,12,0,12,0,12,597,96,137,80,460,99
1500000US530330056003,530330056003,"Block Group 3, Census Tract 56, King County, Washington",529,102,0,12,0,12,0,12,529,102,74,60,455,106
1500000US530330056004,530330056004,"Block Group 4, Census Tract 56, King County, Washington",447,69,0,12,0,12,0,12,447,69,50,47,397,73
1500000US530330056005,530330056005,"Block Group 5, Census Tract 56, King County, Washington",505,105,28,32,0,12,28,32,477,105,33,37,444,104
1500000US530330057001,530330057001,"Block Group 1, Census Tract 57, King County, Washington",236,78,0,12,0,12,0,12,236,78,97,67,139,83
1500000US530330057002,530330057002,"Block Group 2, Census Tract 57, King County, Washington",615,89,0,12,0,12,0,12,615,89,91,70,524,106
1500000US530330057003,530330057003,"Block Group 3, Census Tract 57, King County, Washington",369,113,0,12,0,12,0,12,369,113,75,41,294,113
1500000US530330057004,530330057004,"Block Group 4, Census Tract 57, King County, Washington",356,76,0,12,0,12,0,12,356,76,71,53,285,84
1500000US530330057005,530330057005,"Block Group 5, Census Tract 57, King County, Washington",497,92,0,12,0,12,0,12,497,92,102,57,395,96
1500000US530330057006,530330057006,"Block Group 6, Census Tract 57, King County, Washington",733,106,33,35,33,35,0,12,700,103,37,37,663,108
1500000US530330058011,530330058011,"Block Group 1, Census Tract 58.01, King County, Washington",496,77,0,12,0,12,0,12,496,77,30,35,466,84
1500000US530330058012,530330058012,"Block Group 2, Census Tract 58.01, King County, Washington",870,124,16,26,16,26,0,12,854,128,146,91,708,128
1500000US530330058013,530330058013,"Block Group 3, Census Tract 58.01, King County, Washington",579,103,24,28,12,19,12,20,555,100,112,72,443,94
1500000US530330058014,530330058014,"Block Group 4, Census Tract 58.01, King County, Washington",674,109,82,83,25,29,57,78,592,121,118,86,474,116
1500000US530330058021,530330058021,"Block Group 1, Census Tract 58.02, King County, Washington",857,129,55,74,0,12,55,74,802,119,67,54,735,125
1500000US530330058022,530330058022,"Block Group 2, Census Tract 58.02, King County, Washington",1055,163,43,36,15,26,28,24,1012,162,145,94,867,159
1500000US530330058023,530330058023,"Block Group 3, Census Tract 58.02, King County, Washington",746,131,79,55,29,25,50,49,667,134,76,57,591,143
1500000US530330059001,530330059001,"Block Group 1, Census Tract 59, King County, Washington",822,133,44,40,29,32,15,25,778,133,68,55,710,141
1500000US530330059002,530330059002,"Block Group 2, Census Tract 59, King County, Washington",580,111,0,12,0,12,0,12,580,111,78,43,502,119
1500000US530330059003,530330059003,"Block Group 3, Census Tract 59, King County, Washington",200,85,0,12,0,12,0,12,200,85,0,12,200,85
1500000US530330059004,530330059004,"Block Group 4, Census Tract 59, King County, Washington",627,102,12,19,12,19,0,12,615,102,39,35,576,109
1500000US530330059005,530330059005,"Block Group 5, Census Tract 59, King County, Washington",468,100,24,28,13,23,11,17,444,103,20,21,424,102
1500000US530330060001,530330060001,"Block Group 1, Census Tract 60, King County, Washington",737,131,59,69,44,66,15,25,678,137,86,49,592,129
1500000US530330060002,530330060002,"Block Group 2, Census Tract 60, King County, Washington",570,96,0,12,0,12,0,12,570,96,134,80,436,88
1500000US530330060003,530330060003,"Block Group 3, Census Tract 60, King County, Washington",552,104,14,23,14,23,0,12,538,104,24,38,514,109
1500000US530330060004,530330060004,"Block Group 4, Census Tract 60, King County, Washington",518,108,0,12,0,12,0,12,518,108,13,21,505,108
1500000US530330061001,530330061001,"Block Group 1, Census Tract 61, King County, Washington",709,115,14,24,0,12,14,24,695,115,0,12,695,115
1500000US530330061002,530330061002,"Block Group 2, Census Tract 61, King County, Washington",492,107,15,24,0,12,15,24,477,109,37,39,440,103
1500000US530330061003,530330061003,"Block Group 3, Census Tract 61, King County, Washington",977,134,0,12,0,12,0,12,977,134,29,33,948,139
1500000US530330061004,530330061004,"Block Group 4, Census Tract 61, King County, Washington",861,143,15,25,15,25,0,12,846,148,13,23,833,150
1500000US530330062001,530330062001,"Block Group 1, Census Tract 62, King County, Washington",662,56,37,32,12,18,25,27,625,57,65,40,560,64
1500000US530330062002,530330062002,"Block Group 2, Census Tract 62, King County, Washington",610,54,9,13,0,12,9,13,601,56,49,35,552,62
1500000US530330062003,530330062003,"Block Group 3, Census Tract 62, King County, Washington",342,48,8,14,0,12,8,14,334,47,21,23,313,46
1500000US530330063001,530330063001,"Block Group 1, Census Tract 63, King County, Washington",894,134,0,12,0,12,0,12,894,134,98,87,796,145
1500000US530330063002,530330063002,"Block Group 2, Census Tract 63, King County, Washington",654,121,0,12,0,12,0,12,654,121,143,66,511,122
1500000US530330063003,530330063003,"Block Group 3, Census Tract 63, King County, Washington",536,131,0,12,0,12,0,12,536,131,28,32,508,134
1500000US530330063004,530330063004,"Block Group 4, Census Tract 63, King County, Washington",522,69,0,12,0,12,0,12,522,69,36,35,486,77
1500000US530330064001,530330064001,"Block Group 1, Census Tract 64, King County, Washington",449,73,0,12,0,12,0,12,449,73,58,33,391,73
1500000US530330064002,530330064002,"Block Group 2, Census Tract 64, King County, Washington",368,62,0,12,0,12,0,12,368,62,13,15,355,64
1500000US530330064003,530330064003,"Block Group 3, Census Tract 64, King County, Washington",455,51,0,12,0,12,0,12,455,51,65,39,390,58
1500000US530330065001,530330065001,"Block Group 1, Census Tract 65, King County, Washington",418,82,0,12,0,12,0,12,418,82,20,24,398,88
1500000US530330065002,530330065002,"Block Group 2, Census Tract 65, King County, Washington",993,106,47,68,0,12,47,68,946,120,87,75,859,123
1500000US530330065003,530330065003,"Block Group 3, Census Tract 65, King County, Washington",934,111,11,17,11,17,0,12,923,116,78,56,845,122
1500000US530330066001,530330066001,"Block Group 1, Census Tract 66, King County, Washington",802,160,0,12,0,12,0,12,802,160,62,44,740,158
1500000US530330066002,530330066002,"Block Group 2, Census Tract 66, King County, Washington",1199,181,85,97,12,18,73,96,1114,170,119,87,995,195
1500000US530330067001,530330067001,"Block Group 1, Census Tract 67, King County, Washington",1288,203,16,27,0,12,16,27,1272,208,41,39,1231,215
1500000US530330067002,530330067002,"Block Group 2, Census Tract 67, King County, Washington",1072,133,0,12,0,12,0,12,1072,133,212,100,860,134
1500000US530330067003,530330067003,"Block Group 3, Census Tract 67, King County, Washington",596,126,0,12,0,12,0,12,596,126,10,17,586,126
1500000US530330067004,530330067004,"Block Group 4, Census Tract 67, King County, Washington",996,170,11,18,0,12,11,18,985,170,112,66,873,167
1500000US530330068001,530330068001,"Block Group 1, Census Tract 68, King County, Washington",606,71,8,12,8,12,0,12,598,70,36,30,562,71
1500000US530330068002,530330068002,"Block Group 2, Census Tract 68, King County, Washington",713,95,20,22,20,22,0,12,693,96,41,32,652,90
1500000US530330069001,530330069001,"Block Group 1, Census Tract 69, King County, Washington",478,78,13,20,13,20,0,12,465,80,13,22,452,79
1500000US530330069002,530330069002,"Block Group 2, Census Tract 69, King County, Washington",527,81,33,53,0,12,33,53,494,70,65,43,429,73
1500000US530330069003,530330069003,"Block Group 3, Census Tract 69, King County, Washington",457,73,35,42,18,31,17,28,422,77,12,20,410,75
1500000US530330069004,530330069004,"Block Group 4, Census Tract 69, King County, Washington",566,102,16,24,0,12,16,24,550,112,21,32,529,114
1500000US530330070001,530330070001,"Block Group 1, Census Tract 70, King County, Washington",602,184,11,20,0,12,11,20,591,183,63,62,528,187
1500000US530330070002,530330070002,"Block Group 2, Census Tract 70, King County, Washington",773,132,123,109,84,103,39,44,650,139,52,51,598,130
1500000US530330070003,530330070003,"Block Group 3, Census Tract 70, King County, Washington",1245,185,24,39,0,12,24,39,1221,187,183,134,1038,197
1500000US530330070004,530330070004,"Block Group 4, Census Tract 70, King County, Washington",768,168,36,44,36,44,0,12,732,165,35,56,697,160
1500000US530330070005,530330070005,"Block Group 5, Census Tract 70, King County, Washington",753,155,48,55,22,35,26,40,705,163,132,89,573,159
1500000US530330070006,530330070006,"Block Group 6, Census Tract 70, King County, Washington",725,161,125,90,113,87,12,21,600,159,20,32,580,155
1500000US530330071001,530330071001,"Block Group 1, Census Tract 71, King County, Washington",861,131,180,105,109,61,71,84,681,118,77,44,604,116
1500000US530330071002,530330071002,"Block Group 2, Census Tract 71, King County, Washington",1254,156,16,19,6,10,10,16,1238,156,47,39,1191,157
1500000US530330072001,530330072001,"Block Group 1, Census Tract 72, King County, Washington",1720,240,243,68,50,44,193,59,1477,246,100,67,1377,258
1500000US530330072002,530330072002,"Block Group 2, Census Tract 72, King County, Washington",1122,179,25,30,0,12,25,30,1097,178,126,112,971,181
1500000US530330072003,530330072003,"Block Group 3, Census Tract 72, King County, Washington",1153,226,108,58,46,35,62,53,1045,227,52,53,993,226
1500000US530330073001,530330073001,"Block Group 1, Census Tract 73, King County, Washington",1222,169,110,65,75,64,35,33,1112,170,90,87,1022,176
1500000US530330073002,530330073002,"Block Group 2, Census Tract 73, King County, Washington",916,178,193,107,174,104,19,30,723,175,118,86,605,157
1500000US530330073003,530330073003,"Block Group 3, Census Tract 73, King County, Washington",1109,188,37,35,28,31,9,16,1072,187,120,99,952,190
1500000US530330074011,530330074011,"Block Group 1, Census Tract 74.01, King County, Washington",823,184,0,12,0,12,0,12,823,184,17,28,806,187
1500000US530330074012,530330074012,"Block Group 2, Census Tract 74.01, King County, Washington",887,159,170,97,35,39,135,93,717,162,15,25,702,169
1500000US530330074013,530330074013,"Block Group 3, Census Tract 74.01, King County, Washington",775,168,25,28,0,12,25,28,750,171,156,116,594,153
1500000US530330074014,530330074014,"Block Group 4, Census Tract 74.01, King County, Washington",690,141,12,20,0,12,12,20,678,141,42,49,636,141
1500000US530330074021,530330074021,"Block Group 1, Census Tract 74.02, King County, Washington",1236,182,58,63,12,21,46,60,1178,192,11,19,1167,195
1500000US530330074022,530330074022,"Block Group 2, Census Tract 74.02, King County, Washington",1211,216,197,86,118,77,79,69,1014,206,59,60,955,209
1500000US530330074023,530330074023,"Block Group 3, Census Tract 74.02, King County, Washington",1081,185,218,83,159,69,59,73,863,167,46,33,817,166
1500000US530330075001,530330075001,"Block Group 1, Census Tract 75, King County, Washington",952,196,95,64,43,42,52,52,857,210,46,36,811,215
1500000US530330075002,530330075002,"Block Group 2, Census Tract 75, King County, Washington",771,147,47,56,17,30,30,48,724,149,20,33,704,147
1500000US530330075003,530330075003,"Block Group 3, Census Tract 75, King County, Washington",1232,217,8,14,0,12,8,14,1224,218,16,29,1208,220
1500000US530330075004,530330075004,"Block Group 4, Census Tract 75, King County, Washington",929,223,121,73,15,25,106,68,808,214,42,65,766,216
1500000US530330075005,530330075005,"Block Group 5, Census Tract 75, King County, Washington",581,126,20,32,20,32,0,12,561,125,132,84,429,119
1500000US530330076001,530330076001,"Block Group 1, Census Tract 76, King County, Washington",555,83,30,26,19,20,11,17,525,88,50,35,475,93
1500000US530330076002,530330076002,"Block Group 2, Census Tract 76, King County, Washington",627,90,40,37,17,19,23,33,587,92,61,34,526,94
1500000US530330076003,530330076003,"Block Group 3, Census Tract 76, King County, Washington",731,103,18,21,0,12,18,21,713,102,74,47,639,102
1500000US530330077001,530330077001,"Block Group 1, Census Tract 77, King County, Washington",506,129,47,75,0,12,47,75,459,113,96,65,363,110
1500000US530330077002,530330077002,"Block Group 2, Census Tract 77, King County, Washington",405,89,26,45,0,12,26,45,379,83,89,68,290,66
1500000US530330077003,530330077003,"Block Group 3, Census Tract 77, King County, Washington",432,98,47,52,0,12,47,52,385,94,32,38,353,98
1500000US530330077004,530330077004,"Block Group 4, Census Tract 77, King County, Washington",760,137,114,95,22,36,92,91,646,114,10,17,636,117
1500000US530330078001,530330078001,"Block Group 1, Census Tract 78, King County, Washington",611,110,0,12,0,12,0,12,611,110,37,38,574,115
1500000US530330078002,530330078002,"Block Group 2, Census Tract 78, King County, Washington",650,107,17,26,0,12,17,26,633,110,119,67,514,112
1500000US530330078003,530330078003,"Block Group 3, Census Tract 78, King County, Washington",469,101,57,72,0,12,57,72,412,87,35,38,377,89
1500000US530330078004,530330078004,"Block Group 4, Census Tract 78, King County, Washington",446,86,19,29,19,29,0,12,427,85,55,52,372,91
1500000US530330079001,530330079001,"Block Group 1, Census Tract 79, King County, Washington",422,134,36,38,27,39,9,21,386,129,27,33,359,131
1500000US530330079002,530330079002,"Block Group 2, Census Tract 79, King County, Washington",512,88,77,61,35,39,42,46,435,91,40,42,395,86
1500000US530330079003,530330079003,"Block Group 3, Census Tract 79, King County, Washington",428,97,35,41,0,12,35,41,393,100,33,37,360,103
1500000US530330079004,530330079004,"Block Group 4, Census Tract 79, King County, Washington",911,135,151,111,63,58,88,93,760,126,135,72,625,133
1500000US530330079005,530330079005,"Block Group 5, Census Tract 79, King County, Washington",725,129,92,61,71,52,21,33,633,134,58,51,575,130
1500000US530330080011,530330080011,"Block Group 1, Census Tract 80.01, King County, Washington",931,169,59,72,16,25,43,68,872,189,65,79,807,197
1500000US530330080012,530330080012,"Block Group 2, Census Tract 80.01, King County, Washington",784,221,177,161,39,45,138,155,607,197,221,183,386,138
1500000US530330080013,530330080013,"Block Group 3, Census Tract 80.01, King County, Washington",602,121,121,86,67,62,54,59,481,135,25,41,456,140
1500000US530330080014,530330080014,"Block Group 4, Census Tract 80.01, King County, Washington",770,209,80,48,42,49,38,45,690,203,0,12,690,203
1500000US530330080015,530330080015,"Block Group 5, Census Tract 80.01, King County, Washington",708,197,26,47,26,47,0,12,682,204,14,23,668,206
1500000US530330080021,530330080021,"Block Group 1, Census Tract 80.02, King County, Washington",1234,163,557,160,259,92,298,144,677,164,124,78,553,142
1500000US530330080022,530330080022,"Block Group 2, Census Tract 80.02, King County, Washington",918,143,99,71,61,59,38,39,819,147,50,48,769,143
1500000US530330081001,530330081001,"Block Group 1, Census Tract 81, King County, Washington",1143,192,39,65,0,12,39,65,1104,182,87,54,1017,178
1500000US530330081002,530330081002,"Block Group 2, Census Tract 81, King County, Washington",442,116,122,76,87,71,35,36,320,105,67,68,253,110
1500000US530330081003,530330081003,"Block Group 3, Census Tract 81, King County, Washington",945,135,400,119,294,114,106,60,545,156,28,36,517,155
1500000US530330082001,530330082001,"Block Group 1, Census Tract 82, King County, Washington",740,142,59,42,30,35,29,33,681,148,85,88,596,127
1500000US530330082002,530330082002,"Block Group 2, Census Tract 82, King County, Washington",1027,182,95,105,18,29,77,100,932,183,52,46,880,174
1500000US530330082003,530330082003,"Block Group 3, Census Tract 82, King County, Washington",728,117,36,40,19,29,17,28,692,115,233,95,459,103
1500000US530330083001,530330083001,"Block Group 1, Census Tract 83, King County, Washington",781,114,106,65,59,47,47,45,675,116,102,63,573,98
1500000US530330083002,530330083002,"Block Group 2, Census Tract 83, King County, Washington",1118,154,48,57,32,48,16,17,1070,137,140,79,930,131
1500000US530330084001,530330084001,"Block Group 1, Census Tract 84, King County, Washington",1060,137,91,80,17,27,74,77,969,134,41,37,928,141
1500000US530330084002,530330084002,"Block Group 2, Census Tract 84, King County, Washington",1041,193,164,111,76,78,88,85,877,179,105,63,772,180
1500000US530330084003,530330084003,"Block Group 3, Census Tract 84, King County, Washington",772,150,105,95,0,12,105,95,667,162,28,33,639,164
1500000US530330085001,530330085001,"Block Group 1, Census Tract 85, King County, Washington",701,85,100,57,47,38,53,45,601,84,136,59,465,76
1500000US530330085002,530330085002,"Block Group 2, Census Tract 85, King County, Washington",627,88,173,72,55,47,118,61,454,88,116,57,338,81
1500000US530330085003,530330085003,"Block Group 3, Census Tract 85, King County, Washington",381,75,296,88,219,87,77,50,85,50,28,34,57,41
1500000US530330086001,530330086001,"Block Group 1, Census Tract 86, King County, Washington",643,106,99,52,25,30,74,46,544,106,45,48,499,111
1500000US530330086002,530330086002,"Block Group 2, Census Tract 86, King County, Washington",532,106,39,37,15,17,24,29,493,102,27,44,466,104
1500000US530330086003,530330086003,"Block Group 3, Census Tract 86, King County, Washington",559,96,158,65,85,56,73,36,401,93,46,32,355,89
1500000US530330087001,530330087001,"Block Group 1, Census Tract 87, King County, Washington",607,125,81,62,9,16,72,64,526,115,34,29,492,116
1500000US530330087002,530330087002,"Block Group 2, Census Tract 87, King County, Washington",425,95,83,52,61,54,22,24,342,82,21,21,321,81
1500000US530330087003,530330087003,"Block Group 3, Census Tract 87, King County, Washington",651,99,115,73,26,24,89,64,536,109,62,43,474,103
1500000US530330088001,530330088001,"Block Group 1, Census Tract 88, King County, Washington",557,82,73,41,52,42,21,28,484,88,68,53,416,83
1500000US530330088002,530330088002,"Block Group 2, Census Tract 88, King County, Washington",492,95,43,38,23,32,20,22,449,94,109,63,340,92
1500000US530330088003,530330088003,"Block Group 3, Census Tract 88, King County, Washington",393,82,56,60,0,12,56,60,337,78,47,37,290,79
1500000US530330089001,530330089001,"Block Group 1, Census Tract 89, King County, Washington",515,106,14,23,14,23,0,12,501,107,45,39,456,113
1500000US530330089002,530330089002,"Block Group 2, Census Tract 89, King County, Washington",441,95,0,12,0,12,0,12,441,95,64,46,377,93
1500000US530330089003,530330089003,"Block Group 3, Census Tract 89, King County, Washington",617,170,138,100,138,100,0,12,479,156,77,94,402,143
1500000US530330089004,530330089004,"Block Group 4, Census Tract 89, King County, Washington",474,158,74,63,74,63,0,12,400,146,8,14,392,145
1500000US530330090001,530330090001,"Block Group 1, Census Tract 90, King County, Washington",662,100,60,38,41,33,19,21,602,104,144,57,458,100
1500000US530330090002,530330090002,"Block Group 2, Census Tract 90, King County, Washington",991,108,245,75,149,75,96,55,746,111,103,46,643,111
1500000US530330091001,530330091001,"Block Group 1, Census Tract 91, King County, Washington",526,110,292,98,145,92,147,52,234,76,35,26,199,72
1500000US530330091002,530330091002,"Block Group 2, Census Tract 91, King County, Washington",774,111,230,90,118,74,112,68,544,131,136,87,408,105
1500000US530330092001,530330092001,"Block Group 1, Census Tract 92, King County, Washington",996,114,387,93,246,71,141,86,609,112,115,64,494,117
1500000US530330092002,530330092002,"Block Group 2, Census Tract 92, King County, Washington",746,116,328,116,246,98,82,66,418,82,45,40,373,71
1500000US530330093001,530330093001,"Block Group 1, Census Tract 93, King County, Washington",434,84,45,41,17,18,28,35,389,82,57,36,332,82
1500000US530330093002,530330093002,"Block Group 2, Census Tract 93, King County, Washington",131,68,12,14,0,12,12,14,119,69,7,11,112,69
1500000US530330093003,530330093003,"Block Group 3, Census Tract 93, King County, Washington",387,76,72,35,42,32,30,22,315,75,58,37,257,77
1500000US530330094001,530330094001,"Block Group 1, Census Tract 94, King County, Washington",544,129,194,101,91,66,103,99,350,131,28,35,322,128
1500000US530330094002,530330094002,"Block Group 2, Census Tract 94, King County, Washington",615,120,172,89,81,77,91,64,443,123,61,58,382,122
1500000US530330094003,530330094003,"Block Group 3, Census Tract 94, King County, Washington",360,93,34,37,34,37,0,12,326,97,62,65,264,92
1500000US530330094004,530330094004,"Block Group 4, Census Tract 94, King County, Washington",333,100,14,23,14,23,0,12,319,103,0,12,319,103
1500000US530330094005,530330094005,"Block Group 5, Census Tract 94, King County, Washington",575,129,70,64,23,37,47,53,505,137,29,36,476,139
1500000US530330095001,530330095001,"Block Group 1, Census Tract 95, King County, Washington",654,116,31,35,12,19,19,28,623,121,154,103,469,109
1500000US530330095002,530330095002,"Block Group 2, Census Tract 95, King County, Washington",820,138,206,110,112,83,94,72,614,138,166,92,448,132
1500000US530330095003,530330095003,"Block Group 3, Census Tract 95, King County, Washington",476,80,15,24,15,24,0,12,461,81,0,12,461,81
1500000US530330095004,530330095004,"Block Group 4, Census Tract 95, King County, Washington",502,117,99,80,86,77,13,21,403,91,40,38,363,94
1500000US530330096001,530330096001,"Block Group 1, Census Tract 96, King County, Washington",282,74,18,27,0,12,18,27,264,73,46,53,218,66
1500000US530330096002,530330096002,"Block Group 2, Census Tract 96, King County, Washington",755,109,12,20,0,12,12,20,743,109,149,79,594,107
1500000US530330096003,530330096003,"Block Group 3, Census Tract 96, King County, Washington",561,124,18,28,18,28,0,12,543,123,32,35,511,131
1500000US530330096004,530330096004,"Block Group 4, Census Tract 96, King County, Washington",503,76,0,12,0,12,0,12,503,76,100,75,403,84
1500000US530330096005,530330096005,"Block Group 5, Census Tract 96, King County, Washington",709,121,35,58,0,12,35,58,674,117,0,12,674,117
1500000US530330097011,530330097011,"Block Group 1, Census Tract 97.01, King County, Washington",972,150,0,12,0,12,0,12,972,150,117,70,855,160
1500000US530330097012,530330097012,"Block Group 2, Census Tract 97.01, King County, Washington",604,131,52,49,26,30,26,39,552,132,73,61,479,143
1500000US530330097013,530330097013,"Block Group 3, Census Tract 97.01, King County, Washington",625,130,16,25,0,12,16,25,609,132,142,91,467,113
1500000US530330097014,530330097014,"Block Group 4, Census Tract 97.01, King County, Washington",748,126,25,31,25,31,0,12,723,134,86,63,637,139
1500000US530330097021,530330097021,"Block Group 1, Census Tract 97.02, King County, Washington",513,91,12,18,0,12,12,18,501,94,58,53,443,91
1500000US530330097022,530330097022,"Block Group 2, Census Tract 97.02, King County, Washington",421,66,58,59,46,56,12,18,363,66,97,56,266,75
1500000US530330097023,530330097023,"Block Group 3, Census Tract 97.02, King County, Washington",311,96,52,75,0,12,52,75,259,61,54,40,205,60
1500000US530330097024,530330097024,"Block Group 4, Census Tract 97.02, King County, Washington",418,59,11,18,0,12,11,18,407,61,58,43,349,67
1500000US530330097025,530330097025,"Block Group 5, Census Tract 97.02, King County, Washington",526,101,43,43,0,12,43,43,483,102,56,45,427,101
1500000US530330098001,530330098001,"Block Group 1, Census Tract 98, King County, Washington",577,87,19,31,19,31,0,12,558,90,32,34,526,93
1500000US530330098002,530330098002,"Block Group 2, Census Tract 98, King County, Washington",583,95,19,30,0,12,19,30,564,95,110,73,454,105
1500000US530330098003,530330098003,"Block Group 3, Census Tract 98, King County, Washington",591,89,0,12,0,12,0,12,591,89,86,75,505,71
1500000US530330098004,530330098004,"Block Group 4, Census Tract 98, King County, Washington",653,114,32,27,0,12,32,27,621,111,70,54,551,121
1500000US530330098005,530330098005,"Block Group 5, Census Tract 98, King County, Washington",615,112,13,21,13,21,0,12,602,112,60,72,542,101
1500000US530330099001,530330099001,"Block Group 1, Census Tract 99, King County, Washington",561,124,85,75,0,12,85,75,476,109,76,51,400,121
1500000US530330099002,530330099002,"Block Group 2, Census Tract 99, King County, Washington",699,148,15,25,15,25,0,12,684,150,69,49,615,153
1500000US530330099003,530330099003,"Block Group 3, Census Tract 99, King County, Washington",720,133,40,38,13,22,27,31,680,141,53,43,627,139
1500000US530330099004,530330099004,"Block Group 4, Census Tract 99, King County, Washington",456,131,73,96,0,12,73,96,383,102,17,30,366,100
1500000US530330100011,530330100011,"Block Group 1, Census Tract 100.01, King County, Washington",324,86,53,51,31,37,22,35,271,95,20,30,251,98
1500000US530330100012,530330100012,"Block Group 2, Census Tract 100.01, King County, Washington",605,111,55,47,11,18,44,42,550,119,33,38,517,114
1500000US530330100013,530330100013,"Block Group 3, Census Tract 100.01, King County, Washington",695,118,291,143,164,97,127,109,404,99,66,60,338,90
1500000US530330100021,530330100021,"Block Group 1, Census Tract 100.02, King County, Washington",358,90,27,42,0,12,27,42,331,101,24,26,307,105
1500000US530330100022,530330100022,"Block Group 2, Census Tract 100.02, King County, Washington",606,108,96,65,27,41,69,57,510,114,134,92,376,109
1500000US530330100023,530330100023,"Block Group 3, Census Tract 100.02, King County, Washington",211,65,4,9,4,9,0,12,207,63,36,34,171,61
1500000US530330100024,530330100024,"Block Group 4, Census Tract 100.02, King County, Washington",465,100,45,43,30,35,15,23,420,103,80,50,340,107
1500000US530330101001,530330101001,"Block Group 1, Census Tract 101, King County, Washington",382,88,0,12,0,12,0,12,382,88,17,26,365,88
1500000US530330101002,530330101002,"Block Group 2, Census Tract 101, King County, Washington",459,126,108,111,0,12,108,111,351,79,61,43,290,82
1500000US530330101003,530330101003,"Block Group 3, Census Tract 101, King County, Washington",191,67,50,45,50,45,0,12,141,60,27,33,114,57
1500000US530330101004,530330101004,"Block Group 4, Census Tract 101, King County, Washington",873,164,161,94,60,46,101,86,712,180,238,132,474,176
1500000US530330101005,530330101005,"Block Group 5, Census Tract 101, King County, Washington",741,123,124,104,109,100,15,24,617,114,58,44,559,119
1500000US530330102001,530330102001,"Block Group 1, Census Tract 102, King County, Washington",544,74,0,12,0,12,0,12,544,74,59,37,485,86
1500000US530330102002,530330102002,"Block Group 2, Census Tract 102, King County, Washington",459,80,8,13,0,12,8,13,451,82,98,56,353,82
1500000US530330102003,530330102003,"Block Group 3, Census Tract 102, King County, Washington",385,76,39,28,19,15,20,22,346,77,75,57,271,81
1500000US530330102004,530330102004,"Block Group 4, Census Tract 102, King County, Washington",543,67,15,16,15,16,0,12,528,70,35,27,493,79
1500000US530330103001,530330103001,"Block Group 1, Census Tract 103, King County, Washington",463,117,88,96,0,12,88,96,375,98,14,22,361,99
1500000US530330103002,530330103002,"Block Group 2, Census Tract 103, King County, Washington",403,114,81,51,54,42,27,32,322,119,17,24,305,115
1500000US530330103003,530330103003,"Block Group 3, Census Tract 103, King County, Washington",460,130,129,97,56,50,73,83,331,107,35,32,296,102
1500000US530330103004,530330103004,"Block Group 4, Census Tract 103, King County, Washington",439,132,178,103,58,59,120,91,261,106,15,22,246,110
1500000US530330103005,530330103005,"Block Group 5, Census Tract 103, King County, Washington",641,150,112,80,14,24,98,77,529,168,14,18,515,168
1500000US530330104011,530330104011,"Block Group 1, Census Tract 104.01, King County, Washington",470,67,52,58,48,57,4,9,418,74,42,46,376,66
1500000US530330104012,530330104012,"Block Group 2, Census Tract 104.01, King County, Washington",588,91,162,77,53,34,109,91,426,106,46,36,380,107
1500000US530330104013,530330104013,"Block Group 3, Census Tract 104.01, King County, Washington",434,86,134,80,69,59,65,50,300,83,56,43,244,83
1500000US530330104021,530330104021,"Block Group 1, Census Tract 104.02, King County, Washington",290,72,31,39,31,39,0,12,259,75,51,43,208,73
1500000US530330104022,530330104022,"Block Group 2, Census Tract 104.02, King County, Washington",421,113,37,30,0,12,37,30,384,116,95,83,289,106
1500000US530330104023,530330104023,"Block Group 3, Census Tract 104.02, King County, Washington",339,88,43,40,0,12,43,40,296,90,63,49,233,92
1500000US530330104024,530330104024,"Block Group 4, Census Tract 104.02, King County, Washington",419,107,10,15,0,12,10,15,409,109,48,41,361,108
1500000US530330105001,530330105001,"Block Group 1, Census Tract 105, King County, Washington",457,115,0,12,0,12,0,12,457,115,172,82,285,86
1500000US530330105002,530330105002,"Block Group 2, Census Tract 105, King County, Washington",721,119,44,71,44,71,0,12,677,102,13,21,664,101
1500000US530330105003,530330105003,"Block Group 3, Census Tract 105, King County, Washington",401,88,14,22,0,12,14,22,387,87,33,35,354,92
1500000US530330105004,530330105004,"Block Group 4, Census Tract 105, King County, Washington",902,167,67,72,53,68,14,21,835,162,134,82,701,169
1500000US530330105005,530330105005,"Block Group 5, Census Tract 105, King County, Washington",691,99,76,70,65,68,11,18,615,100,101,51,514,118
1500000US530330106001,530330106001,"Block Group 1, Census Tract 106, King County, Washington",684,127,16,25,16,25,0,12,668,129,58,51,610,129
1500000US530330106002,530330106002,"Block Group 2, Census Tract 106, King County, Washington",500,126,78,79,22,34,56,72,422,111,35,40,387,109
1500000US530330106003,530330106003,"Block Group 3, Census Tract 106, King County, Washington",867,115,82,68,34,52,48,44,785,114,96,61,689,124
1500000US530330106004,530330106004,"Block Group 4, Census Tract 106, King County, Washington",390,87,0,12,0,12,0,12,390,87,18,29,372,87
1500000US530330106005,530330106005,"Block Group 5, Census Tract 106, King County, Washington",687,107,25,35,25,35,0,12,662,110,119,60,543,110
1500000US530330106006,530330106006,"Block Group 6, Census Tract 106, King County, Washington",476,70,55,48,25,35,30,32,421,84,34,41,387,88
1500000US530330107011,530330107011,"Block Group 1, Census Tract 107.01, King County, Washington",921,152,351,115,140,99,211,122,570,163,64,69,506,154
1500000US530330107012,530330107012,"Block Group 2, Census Tract 107.01, King County, Washington",409,122,83,80,42,55,41,57,326,88,93,65,233,74
1500000US530330107021,530330107021,"Block Group 1, Census Tract 107.02, King County, Washington",429,94,31,31,10,15,21,26,398,91,2,8,396,93
1500000US530330107022,530330107022,"Block Group 2, Census Tract 107.02, King County, Washington",488,116,201,67,133,67,68,62,287,102,41,47,246,101
1500000US530330107023,530330107023,"Block Group 3, Census Tract 107.02, King County, Washington",511,97,183,54,39,35,144,45,328,99,42,44,286,99
1500000US530330108001,530330108001,"Block Group 1, Census Tract 108, King County, Washington",505,90,123,73,15,17,108,71,382,79,25,20,357,80
1500000US530330108002,530330108002,"Block Group 2, Census Tract 108, King County, Washington",454,94,90,56,0,12,90,56,364,81,66,52,298,80
1500000US530330108003,530330108003,"Block Group 3, Census Tract 108, King County, Washington",744,101,129,74,75,53,54,48,615,115,33,27,582,115
1500000US530330109001,530330109001,"Block Group 1, Census Tract 109, King County, Washington",314,56,24,24,4,8,20,22,290,52,32,26,258,53
1500000US530330109002,530330109002,"Block Group 2, Census Tract 109, King County, Washington",307,59,49,37,34,29,15,19,258,65,21,22,237,64
1500000US530330110011,530330110011,"Block Group 1, Census Tract 110.01, King County, Washington",377,96,147,59,64,64,83,48,230,76,8,14,222,75
1500000US530330110012,530330110012,"Block Group 2, Census Tract 110.01, King County, Washington",407,109,90,62,56,40,34,53,317,99,168,71,149,80
1500000US530330110013,530330110013,"Block Group 3, Census Tract 110.01, King County, Washington",807,126,360,128,218,107,142,86,447,117,84,60,363,114
1500000US530330110021,530330110021,"Block Group 1, Census Tract 110.02, King County, Washington",221,65,30,33,0,12,30,33,191,63,43,29,148,68
1500000US530330110022,530330110022,"Block Group 2, Census Tract 110.02, King County, Washington",668,90,298,98,50,42,248,86,370,110,35,34,335,107
1500000US530330110023,530330110023,"Block Group 3, Census Tract 110.02, King County, Washington",372,89,55,65,39,60,16,25,317,78,49,36,268,82
1500000US530330111011,530330111011,"Block Group 1, Census Tract 111.01, King County, Washington",366,82,211,73,151,68,60,37,155,77,52,35,103,70
1500000US530330111012,530330111012,"Block Group 2, Census Tract 111.01, King County, Washington",512,119,125,82,46,59,79,62,387,99,91,58,296,100
1500000US530330111013,530330111013,"Block Group 3, Census Tract 111.01, King County, Washington",333,93,48,41,13,19,35,38,285,99,16,20,269,97
1500000US530330111014,530330111014,"Block Group 4, Census Tract 111.01, King County, Washington",395,88,104,55,51,36,53,57,291,69,75,41,216,69
1500000US530330111021,530330111021,"Block Group 1, Census Tract 111.02, King County, Washington",406,66,0,12,0,12,0,12,406,66,82,46,324,68
1500000US530330111022,530330111022,"Block Group 2, Census Tract 111.02, King County, Washington",398,97,70,46,70,46,0,12,328,97,82,51,246,89
1500000US530330111023,530330111023,"Block Group 3, Census Tract 111.02, King County, Washington",315,84,80,53,17,14,63,52,235,88,57,44,178,82
1500000US530330111024,530330111024,"Block Group 4, Census Tract 111.02, King County, Washington",291,71,43,38,23,27,20,25,248,70,7,11,241,69
1500000US530330112001,530330112001,"Block Group 1, Census Tract 112, King County, Washington",594,88,173,90,71,50,102,78,421,100,77,55,344,86
1500000US530330112002,530330112002,"Block Group 2, Census Tract 112, King County, Washington",255,68,7,12,7,12,0,12,248,69,63,56,185,58
1500000US530330112003,530330112003,"Block Group 3, Census Tract 112, King County, Washington",533,99,213,95,62,53,151,89,320,84,56,46,264,81
1500000US530330113001,530330113001,"Block Group 1, Census Tract 113, King County, Washington",1118,154,282,116,199,103,83,68,836,140,174,83,662,126
1500000US530330113002,530330113002,"Block Group 2, Census Tract 113, King County, Washington",312,89,49,45,0,12,49,45,263,92,19,30,244,91
1500000US530330113003,530330113003,"Block Group 3, Census Tract 113, King County, Washington",312,84,30,34,12,21,18,28,282,80,46,42,236,89
1500000US530330113004,530330113004,"Block Group 4, Census Tract 113, King County, Washington",528,123,69,89,17,32,52,78,459,106,79,70,380,103
1500000US530330113005,530330113005,"Block Group 5, Census Tract 113, King County, Washington",444,121,82,65,0,12,82,65,362,109,72,56,290,92
1500000US530330114011,530330114011,"Block Group 1, Census Tract 114.01, King County, Washington",609,113,98,67,55,72,43,56,511,99,122,67,389,92
1500000US530330114012,530330114012,"Block Group 2, Census Tract 114.01, King County, Washington",557,119,91,69,28,35,63,60,466,117,74,52,392,118
1500000US530330114013,530330114013,"Block Group 3, Census Tract 114.01, King County, Washington",498,80,42,34,0,12,42,34,456,80,90,57,366,74
1500000US530330114021,530330114021,"Block Group 1, Census Tract 114.02, King County, Washington",572,95,46,41,34,35,12,19,526,100,64,44,462,108
1500000US530330114022,530330114022,"Block Group 2, Census Tract 114.02, King County, Washington",637,116,130,79,34,38,96,76,507,113,125,83,382,106
1500000US530330114023,530330114023,"Block Group 3, Census Tract 114.02, King County, Washington",642,108,188,62,56,37,132,60,454,99,170,67,284,77
1500000US530330115001,530330115001,"Block Group 1, Census Tract 115, King County, Washington",541,74,33,23,18,21,15,16,508,74,106,47,402,77
1500000US530330115002,530330115002,"Block Group 2, Census Tract 115, King County, Washington",610,88,6,11,0,12,6,11,604,89,41,32,563,89
1500000US530330115003,530330115003,"Block Group 3, Census Tract 115, King County, Washington",779,88,98,56,40,31,58,54,681,77,92,46,589,83
1500000US530330116001,530330116001,"Block Group 1, Census Tract 116, King County, Washington",520,113,0,12,0,12,0,12,520,113,57,67,463,110
1500000US530330116002,530330116002,"Block Group 2, Census Tract 116, King County, Washington",497,112,13,21,13,21,0,12,484,115,9,19,475,115
1500000US530330116003,530330116003,"Block Group 3, Census Tract 116, King County, Washington",640,117,0,12,0,12,0,12,640,117,94,63,546,138
1500000US530330116004,530330116004,"Block Group 4, Census Tract 116, King County, Washington",380,70,0,12,0,12,0,12,380,70,40,39,340,77
1500000US530330116005,530330116005,"Block Group 5, Census Tract 116, King County, Washington",423,78,0,12,0,12,0,12,423,78,15,25,408,82
1500000US530330116006,530330116006,"Block Group 6, Census Tract 116, King County, Washington",416,92,28,31,28,31,0,12,388,90,53,50,335,81
1500000US530330117001,530330117001,"Block Group 1, Census Tract 117, King County, Washington",468,93,124,73,9,14,115,72,344,96,87,49,257,98
1500000US530330117002,530330117002,"Block Group 2, Census Tract 117, King County, Washington",429,83,84,50,45,36,39,38,345,87,122,69,223,82
1500000US530330117003,530330117003,"Block Group 3, Census Tract 117, King County, Washington",571,79,113,62,70,57,43,32,458,85,111,51,347,91
1500000US530330117004,530330117004,"Block Group 4, Census Tract 117, King County, Washington",253,81,38,34,8,14,30,30,215,83,62,38,153,77
1500000US530330118001,530330118001,"Block Group 1, Census Tract 118, King County, Washington",413,115,21,28,12,21,9,18,392,113,138,90,254,91
1500000US530330118002,530330118002,"Block Group 2, Census Tract 118, King County, Washington",562,143,60,63,13,22,47,59,502,132,125,120,377,130
1500000US530330118003,530330118003,"Block Group 3, Census Tract 118, King County, Washington",339,119,31,36,31,36,0,12,308,129,17,27,291,124
1500000US530330118004,530330118004,"Block Group 4, Census Tract 118, King County, Washington",475,117,277,118,60,45,217,117,198,88,63,50,135,81
1500000US530330118005,530330118005,"Block Group 5, Census Tract 118, King County, Washington",337,79,84,50,55,37,29,34,253,75,50,46,203,65
1500000US530330118006,530330118006,"Block Group 6, Census Tract 118, King County, Washington",765,155,336,152,120,88,216,134,429,138,85,74,344,136
1500000US530330119001,530330119001,"Block Group 1, Census Tract 119, King County, Washington",562,120,13,21,13,21,0,12,549,119,99,57,450,129
1500000US530330119002,530330119002,"Block Group 2, Census Tract 119, King County, Washington",597,126,112,84,43,63,69,58,485,131,76,46,409,129
1500000US530330119003,530330119003,"Block Group 3, Census Tract 119, King County, Washington",471,124,116,109,26,39,90,102,355,126,76,56,279,125
1500000US530330119004,530330119004,"Block Group 4, Census Tract 119, King County, Washington",442,135,189,119,116,102,73,76,253,118,60,49,193,111
1500000US530330119005,530330119005,"Block Group 5, Census Tract 119, King County, Washington",432,134,65,49,65,49,0,12,367,140,34,41,333,135
1500000US530330120001,530330120001,"Block Group 1, Census Tract 120, King County, Washington",460,67,52,47,42,46,10,15,408,67,26,22,382,68
1500000US530330120002,530330120002,"Block Group 2, Census Tract 120, King County, Washington",481,84,9,15,9,15,0,12,472,86,15,16,457,87
1500000US530330120003,530330120003,"Block Group 3, Census Tract 120, King County, Washington",493,76,16,17,16,17,0,12,477,78,37,32,440,80
1500000US530330121001,530330121001,"Block Group 1, Census Tract 121, King County, Washington",531,66,0,12,0,12,0,12,531,66,45,33,486,67
1500000US530330121002,530330121002,"Block Group 2, Census Tract 121, King County, Washington",644,69,31,28,11,16,20,24,613,75,156,54,457,86
1500000US530330201001,530330201001,"Block Group 1, Census Tract 201, King County, Washington",502,53,11,18,0,12,11,18,491,56,52,33,439,61
1500000US530330201002,530330201002,"Block Group 2, Census Tract 201, King County, Washington",414,58,10,16,0,12,10,16,404,58,76,51,328,65
1500000US530330201003,530330201003,"Block Group 3, Census Tract 201, King County, Washington",336,55,8,13,0,12,8,13,328,51,51,35,277,58
1500000US530330202001,530330202001,"Block Group 1, Census Tract 202, King County, Washington",327,78,40,43,18,27,22,33,287,73,24,27,263,76
1500000US530330202002,530330202002,"Block Group 2, Census Tract 202, King County, Washington",643,132,9,18,9,18,0,12,634,133,261,100,373,120
1500000US530330202003,530330202003,"Block Group 3, Census Tract 202, King County, Washington",337,86,70,71,70,71,0,12,267,55,57,45,210,56
1500000US530330202004,530330202004,"Block Group 4, Census Tract 202, King County, Washington",359,63,14,22,0,12,14,22,345,62,39,37,306,60
1500000US530330202005,530330202005,"Block Group 5, Census Tract 202, King County, Washington",448,97,0,12,0,12,0,12,448,97,81,45,367,96
1500000US530330203001,530330203001,"Block Group 1, Census Tract 203, King County, Washington",615,129,30,45,0,12,30,45,585,123,53,44,532,135
1500000US530330203002,530330203002,"Block Group 2, Census Tract 203, King County, Washington",453,121,10,16,10,16,0,12,443,124,61,46,382,129
1500000US530330203003,530330203003,"Block Group 3, Census Tract 203, King County, Washington",412,91,32,36,15,21,17,27,380,99,156,61,224,93
1500000US530330203004,530330203004,"Block Group 4, Census Tract 203, King County, Washington",405,89,56,49,21,32,35,39,349,94,46,46,303,87
1500000US530330203005,530330203005,"Block Group 5, Census Tract 203, King County, Washington",888,164,183,105,79,59,104,93,705,164,156,90,549,170
1500000US530330204011,530330204011,"Block Group 1, Census Tract 204.01, King County, Washington",783,77,98,66,45,45,53,55,685,80,105,70,580,88
1500000US530330204012,530330204012,"Block Group 2, Census Tract 204.01, King County, Washington",323,55,0,12,0,12,0,12,323,55,57,48,266,59
1500000US530330204013,530330204013,"Block Group 3, Census Tract 204.01, King County, Washington",256,51,14,21,0,12,14,21,242,49,64,40,178,48
1500000US530330204021,530330204021,"Block Group 1, Census Tract 204.02, King County, Washington",456,96,42,40,0,12,42,40,414,97,107,75,307,86
1500000US530330204022,530330204022,"Block Group 2, Census Tract 204.02, King County, Washington",472,107,0,12,0,12,0,12,472,107,89,73,383,106
1500000US530330204023,530330204023,"Block Group 3, Census Tract 204.02, King County, Washington",259,75,44,36,30,35,14,23,215,75,29,32,186,84
1500000US530330204024,530330204024,"Block Group 4, Census Tract 204.02, King County, Washington",377,74,0,12,0,12,0,12,377,74,28,31,349,80
1500000US530330204025,530330204025,"Block Group 5, Census Tract 204.02, King County, Washington",604,96,85,33,31,35,54,38,519,101,27,31,492,110
1500000US530330205001,530330205001,"Block Group 1, Census Tract 205, King County, Washington",865,112,130,51,105,51,25,28,735,107,101,85,634,116
1500000US530330205002,530330205002,"Block Group 2, Census Tract 205, King County, Washington",432,89,12,19,12,19,0,12,420,91,83,80,337,87
1500000US530330205003,530330205003,"Block Group 3, Census Tract 205, King County, Washington",579,103,17,25,17,25,0,12,562,100,65,65,497,101
1500000US530330205004,530330205004,"Block Group 4, Census Tract 205, King County, Washington",203,59,8,17,8,17,0,12,195,57,31,26,164,59
1500000US530330205005,530330205005,"Block Group 5, Census Tract 205, King County, Washington",297,97,20,33,20,33,0,12,277,93,25,32,252,98
1500000US530330205006,530330205006,"Block Group 6, Census Tract 205, King County, Washington",250,63,32,36,32,36,0,12,218,68,75,41,143,66
1500000US530330206001,530330206001,"Block Group 1, Census Tract 206, King County, Washington",364,69,10,15,3,9,7,11,354,68,86,44,268,72
1500000US530330206002,530330206002,"Block Group 2, Census Tract 206, King County, Washington",360,72,80,53,54,48,26,20,280,70,37,30,243,65
1500000US530330206003,530330206003,"Block Group 3, Census Tract 206, King County, Washington",302,78,11,19,11,19,0,12,291,77,26,31,265,72
1500000US530330206004,530330206004,"Block Group 4, Census Tract 206, King County, Washington",252,58,19,24,11,18,8,15,233,58,60,47,173,48
1500000US530330207001,530330207001,"Block Group 1, Census Tract 207, King County, Washington",498,89,92,72,65,69,27,26,406,82,82,43,324,73
1500000US530330207002,530330207002,"Block Group 2, Census Tract 207, King County, Washington",588,84,215,78,186,76,29,25,373,81,79,46,294,80
1500000US530330207003,530330207003,"Block Group 3, Census Tract 207, King County, Washington",404,83,0,12,0,12,0,12,404,83,133,68,271,71
1500000US530330208001,530330208001,"Block Group 1, Census Tract 208, King County, Washington",495,78,25,26,9,14,16,23,470,77,108,47,362,74
1500000US530330208002,530330208002,"Block Group 2, Census Tract 208, King County, Washington",366,65,44,31,6,11,38,30,322,62,46,30,276,65
1500000US530330208003,530330208003,"Block Group 3, Census Tract 208, King County, Washington",402,65,27,31,17,29,10,15,375,62,37,30,338,65
1500000US530330208004,530330208004,"Block Group 4, Census Tract 208, King County, Washington",377,75,7,13,7,13,0,12,370,75,50,31,320,83
1500000US530330209001,530330209001,"Block Group 1, Census Tract 209, King County, Washington",576,99,76,67,11,18,65,64,500,96,144,46,356,96
1500000US530330209002,530330209002,"Block Group 2, Census Tract 209, King County, Washington",426,58,59,37,35,35,24,18,367,64,47,31,320,69
1500000US530330209003,530330209003,"Block Group 3, Census Tract 209, King County, Washington",384,68,59,60,10,16,49,58,325,83,17,20,308,85
1500000US530330210001,530330210001,"Block Group 1, Census Tract 210, King County, Washington",287,57,16,23,0,12,16,23,271,63,73,37,198,70
1500000US530330210002,530330210002,"Block Group 2, Census Tract 210, King County, Washington",443,88,0,12,0,12,0,12,443,88,107,50,336,78
1500000US530330210003,530330210003,"Block Group 3, Census Tract 210, King County, Washington",603,128,65,69,11,18,54,65,538,144,104,47,434,145
1500000US530330210004,530330210004,"Block Group 4, Census Tract 210, King County, Washington",455,106,25,28,14,24,11,17,430,114,171,116,259,74
1500000US530330210005,530330210005,"Block Group 5, Census Tract 210, King County, Washington",341,106,26,33,17,28,9,17,315,107,71,50,244,109
1500000US530330211001,530330211001,"Block Group 1, Census Tract 211, King County, Washington",661,86,96,73,52,57,44,46,565,84,87,60,478,95
1500000US530330211002,530330211002,"Block Group 2, Census Tract 211, King County, Washington",376,69,42,38,21,18,21,33,334,70,94,51,240,55
1500000US530330211003,530330211003,"Block Group 3, Census Tract 211, King County, Washington",579,86,157,73,63,48,94,59,422,91,49,34,373,91
1500000US530330211004,530330211004,"Block Group 4, Census Tract 211, King County, Washington",0,12,0,12,0,12,0,12,0,12,0,12,0,12
1500000US530330213001,530330213001,"Block Group 1, Census Tract 213, King County, Washington",547,84,28,25,8,12,20,22,519,86,70,40,449,83
1500000US530330213002,530330213002,"Block Group 2, Census Tract 213, King County, Washington",493,95,62,49,34,43,28,23,431,91,62,55,369,82
1500000US530330213003,530330213003,"Block Group 3, Census Tract 213, King County, Washington",566,104,95,46,39,39,56,32,471,106,14,13,457,107
1500000US530330214001,530330214001,"Block Group 1, Census Tract 214, King County, Washington",386,64,18,19,0,12,18,19,368,70,93,54,275,75
1500000US530330214002,530330214002,"Block Group 2, Census Tract 214, King County, Washington",583,86,63,54,44,51,19,21,520,78,64,40,456,85
1500000US530330214003,530330214003,"Block Group 3, Census Tract 214, King County, Washington",447,68,0,12,0,12,0,12,447,68,32,28,415,73
1500000US530330215001,530330215001,"Block Group 1, Census Tract 215, King County, Washington",361,76,0,12,0,12,0,12,361,76,71,35,290,75
1500000US530330215002,530330215002,"Block Group 2, Census Tract 215, King County, Washington",343,55,0,12,0,12,0,12,343,55,40,23,303,56
1500000US530330215003,530330215003,"Block Group 3, Census Tract 215, King County, Washington",588,83,0,12,0,12,0,12,588,83,105,53,483,86
1500000US530330215004,530330215004,"Block Group 4, Census Tract 215, King County, Washington",377,62,10,15,10,15,0,12,367,62,17,20,350,63
1500000US530330216001,530330216001,"Block Group 1, Census Tract 216, King County, Washington",561,75,41,26,14,16,27,25,520,78,130,66,390,82
1500000US530330216002,530330216002,"Block Group 2, Census Tract 216, King County, Washington",368,80,23,24,0,12,23,24,345,80,103,48,242,69
1500000US530330216003,530330216003,"Block Group 3, Census Tract 216, King County, Washington",511,64,57,34,0,12,57,34,454,66,58,31,396,69
1500000US530330216004,530330216004,"Block Group 4, Census Tract 216, King County, Washington",318,52,47,52,9,15,38,50,271,54,60,33,211,54
1500000US530330217001,530330217001,"Block Group 1, Census Tract 217, King County, Washington",627,131,124,80,78,82,46,74,503,117,119,68,384,110
1500000US530330217002,530330217002,"Block Group 2, Census Tract 217, King County, Washington",573,81,43,48,0,12,43,48,530,76,57,57,473,91
1500000US530330217003,530330217003,"Block Group 3, Census Tract 217, King County, Washington",425,81,11,18,11,18,0,12,414,84,85,60,329,77
1500000US530330217004,530330217004,"Block Group 4, Census Tract 217, King County, Washington",720,152,128,75,73,43,55,61,592,144,264,129,328,117
1500000US530330217005,530330217005,"Block Group 5, Census Tract 217, King County, Washington",1008,183,90,53,33,31,57,41,918,186,124,56,794,196
1500000US530330218021,530330218021,"Block Group 1, Census Tract 218.02, King County, Washington",653,119,45,51,0,12,45,51,608,119,54,43,554,117
1500000US530330218022,530330218022,"Block Group 2, Census Tract 218.02, King County, Washington",955,133,130,100,101,94,29,45,825,162,102,74,723,148
1500000US530330218023,530330218023,"Block Group 3, Census Tract 218.02, King County, Washington",488,104,11,18,11,18,0,12,477,112,34,32,443,110
1500000US530330218031,530330218031,"Block Group 1, Census Tract 218.03, King County, Washington",519,65,94,53,33,29,61,50,425,69,91,50,334,64
1500000US530330218032,530330218032,"Block Group 2, Census Tract 218.03, King County, Washington",310,67,57,40,49,38,8,13,253,65,75,58,178,44
1500000US530330218033,530330218033,"Block Group 3, Census Tract 218.03, King County, Washington",539,90,21,23,13,19,8,14,518,90,106,64,412,92
1500000US530330218034,530330218034,"Block Group 4, Census Tract 218.03, King County, Washington",443,69,69,64,0,12,69,64,374,87,80,45,294,88
1500000US530330218041,530330218041,"Block Group 1, Census Tract 218.04, King County, Washington",617,89,25,39,25,39,0,12,592,89,94,47,498,89
1500000US530330218042,530330218042,"Block Group 2, Census Tract 218.04, King County, Washington",495,99,49,33,19,20,30,26,446,100,82,40,364,97
1500000US530330218043,530330218043,"Block Group 3, Census Tract 218.04, King County, Washington",526,93,41,48,12,17,29,46,485,91,39,30,446,95
1500000US530330219031,530330219031,"Block Group 1, Census Tract 219.03, King County, Washington",856,139,62,58,25,40,37,43,794,137,183,88,611,132
1500000US530330219032,530330219032,"Block Group 2, Census Tract 219.03, King County, Washington",315,64,0,12,0,12,0,12,315,64,80,56,235,74
1500000US530330219033,530330219033,"Block Group 3, Census Tract 219.03, King County, Washington",202,55,0,12,0,12,0,12,202,55,38,44,164,52
1500000US530330219034,530330219034,"Block Group 4, Census Tract 219.03, King County, Washington",220,51,21,33,0,12,21,33,199,57,29,38,170,59
1500000US530330219035,530330219035,"Block Group 5, Census Tract 219.03, King County, Washington",559,121,0,12,0,12,0,12,559,121,21,23,538,123
1500000US530330219041,530330219041,"Block Group 1, Census Tract 219.04, King County, Washington",617,63,151,56,71,39,80,37,466,65,44,29,422,66
1500000US530330219042,530330219042,"Block Group 2, Census Tract 219.04, King County, Washington",267,42,16,21,0,12,16,21,251,46,0,12,251,46
1500000US530330219043,530330219043,"Block Group 3, Census Tract 219.04, King County, Washington",458,68,12,14,0,12,12,14,446,66,99,51,347,81
1500000US530330219044,530330219044,"Block Group 4, Census Tract 219.04, King County, Washington",308,50,0,12,0,12,0,12,308,50,18,19,290,52
1500000US530330219051,530330219051,"Block Group 1, Census Tract 219.05, King County, Washington",744,136,15,24,15,24,0,12,729,137,26,31,703,140
1500000US530330219052,530330219052,"Block Group 2, Census Tract 219.05, King County, Washington",433,88,0,12,0,12,0,12,433,88,63,44,370,87
1500000US530330219053,530330219053,"Block Group 3, Census Tract 219.05, King County, Washington",513,111,46,48,0,12,46,48,467,114,101,76,366,106
1500000US530330219054,530330219054,"Block Group 4, Census Tract 219.05, King County, Washington",390,77,45,37,9,15,36,33,345,87,108,81,237,90
1500000US530330219061,530330219061,"Block Group 1, Census Tract 219.06, King County, Washington",760,93,13,19,0,12,13,19,747,96,114,69,633,110
1500000US530330219062,530330219062,"Block Group 2, Census Tract 219.06, King County, Washington",275,55,0,12,0,12,0,12,275,55,15,13,260,56
1500000US530330219063,530330219063,"Block Group 3, Census Tract 219.06, King County, Washington",624,89,52,53,9,15,43,51,572,95,45,29,527,97
1500000US530330220011,530330220011,"Block Group 1, Census Tract 220.01, King County, Washington",534,138,44,53,0,12,44,53,490,136,11,17,479,136
1500000US530330220012,530330220012,"Block Group 2, Census Tract 220.01, King County, Washington",1028,131,97,61,46,47,51,46,931,147,457,130,474,133
1500000US530330220013,530330220013,"Block Group 3, Census Tract 220.01, King County, Washington",574,142,22,25,11,16,11,19,552,141,70,51,482,151
1500000US530330220031,530330220031,"Block Group 1, Census Tract 220.03, King County, Washington",534,75,20,23,20,23,0,12,514,77,112,56,402,86
1500000US530330220032,530330220032,"Block Group 2, Census Tract 220.03, King County, Washington",343,83,0,12,0,12,0,12,343,83,58,38,285,90
1500000US530330220033,530330220033,"Block Group 3, Census Tract 220.03, King County, Washington",292,74,0,12,0,12,0,12,292,74,49,33,243,77
1500000US530330220034,530330220034,"Block Group 4, Census Tract 220.03, King County, Washington",272,48,12,19,12,19,0,12,260,54,22,25,238,58
1500000US530330220035,530330220035,"Block Group 5, Census Tract 220.03, King County, Washington",334,79,30,35,0,12,30,35,304,77,56,51,248,71
1500000US530330220051,530330220051,"Block Group 1, Census Tract 220.05, King County, Washington",747,99,36,41,21,33,15,23,711,109,137,87,574,120
1500000US530330220052,530330220052,"Block Group 2, Census Tract 220.05, King County, Washington",358,94,0,12,0,12,0,12,358,94,61,51,297,93
1500000US530330220053,530330220053,"Block Group 3, Census Tract 220.05, King County, Washington",838,121,24,28,11,18,13,21,814,128,39,40,775,127
1500000US530330220061,530330220061,"Block Group 1, Census Tract 220.06, King County, Washington",495,65,9,17,9,17,0,12,486,66,90,41,396,74
1500000US530330220062,530330220062,"Block Group 2, Census Tract 220.06, King County, Washington",555,80,7,11,0,12,7,11,548,81,76,42,472,84
1500000US530330220063,530330220063,"Block Group 3, Census Tract 220.06, King County, Washington",458,77,81,63,28,32,53,54,377,85,71,44,306,92
1500000US530330221011,530330221011,"Block Group 1, Census Tract 221.01, King County, Washington",520,72,56,40,19,21,37,34,464,78,116,51,348,81
1500000US530330221012,530330221012,"Block Group 2, Census Tract 221.01, King County, Washington",402,70,19,21,0,12,19,21,383,72,70,51,313,66
1500000US530330221013,530330221013,"Block Group 3, Census Tract 221.01, King County, Washington",589,81,83,61,38,45,45,46,506,90,66,33,440,91
1500000US530330221014,530330221014,"Block Group 4, Census Tract 221.01, King County, Washington",302,65,20,17,9,16,11,16,282,67,45,32,237,69
1500000US530330221021,530330221021,"Block Group 1, Census Tract 221.02, King County, Washington",1067,123,44,41,0,12,44,41,1023,128,154,88,869,120
1500000US530330221022,530330221022,"Block Group 2, Census Tract 221.02, King County, Washington",290,62,16,25,16,25,0,12,274,61,0,12,274,61
1500000US530330221023,530330221023,"Block Group 3, Census Tract 221.02, King County, Washington",447,82,14,23,14,23,0,12,433,82,50,44,383,87
1500000US530330221024,530330221024,"Block Group 4, Census Tract 221.02, King County, Washington",439,74,0,12,0,12,0,12,439,74,73,48,366,80
1500000US530330222011,530330222011,"Block Group 1, Census Tract 222.01, King County, Washington",328,70,54,54,13,21,41,50,274,59,70,44,204,58
1500000US530330222012,530330222012,"Block Group 2, Census Tract 222.01, King County, Washington",274,51,11,15,0,12,11,15,263,53,31,27,232,53
1500000US530330222013,530330222013,"Block Group 3, Census Tract 222.01, King County, Washington",595,72,87,62,31,29,56,57,508,92,115,51,393,98
1500000US530330222014,530330222014,"Block Group 4, Census Tract 222.01, King County, Washington",375,60,10,16,0,12,10,16,365,59,54,33,311,65
1500000US530330222021,530330222021,"Block Group 1, Census Tract 222.02, King County, Washington",442,77,40,27,19,23,21,18,402,67,33,29,369,75
1500000US530330222022,530330222022,"Block Group 2, Census Tract 222.02, King County, Washington",493,111,10,16,10,16,0,12,483,112,53,52,430,112
1500000US530330222023,530330222023,"Block Group 3, Census Tract 222.02, King County, Washington",518,91,42,42,18,29,24,31,476,84,112,53,364,99
1500000US530330222024,530330222024,"Block Group 4, Census Tract 222.02, King County, Washington",303,62,11,18,0,12,11,18,292,68,28,34,264,70
1500000US530330222025,530330222025,"Block Group 5, Census Tract 222.02, King County, Washington",1186,145,59,41,42,31,17,27,1127,152,171,88,956,162
1500000US530330222031,530330222031,"Block Group 1, Census Tract 222.03, King County, Washington",723,68,0,12,0,12,0,12,723,68,101,55,622,78
1500000US530330222032,530330222032,"Block Group 2, Census Tract 222.03, King County, Washington",547,59,0,12,0,12,0,12,547,59,87,42,460,59
1500000US530330222033,530330222033,"Block Group 3, Census Tract 222.03, King County, Washington",466,80,20,22,11,18,9,14,446,82,91,54,355,82
1500000US530330223001,530330223001,"Block Group 1, Census Tract 223, King County, Washington",556,53,0,12,0,12,0,12,556,53,121,67,435,57
1500000US530330223002,530330223002,"Block Group 2, Census Tract 223, King County, Washington",350,54,0,12,0,12,0,12,350,54,20,27,330,47
1500000US530330224001,530330224001,"Block Group 1, Census Tract 224, King County, Washington",583,100,34,39,17,28,17,29,549,97,71,48,478,95
1500000US530330224002,530330224002,"Block Group 2, Census Tract 224, King County, Washington",492,72,0,12,0,12,0,12,492,72,41,38,451,79
1500000US530330224003,530330224003,"Block Group 3, Census Tract 224, King County, Washington",592,119,14,22,0,12,14,22,578,119,9,15,569,121
1500000US530330224004,530330224004,"Block Group 4, Census Tract 224, King County, Washington",827,130,30,33,16,25,14,22,797,135,47,43,750,139
1500000US530330224005,530330224005,"Block Group 5, Census Tract 224, King County, Washington",373,126,19,31,19,31,0,12,354,129,15,22,339,129
1500000US530330224006,530330224006,"Block Group 6, Census Tract 224, King County, Washington",474,100,32,51,0,12,32,51,442,99,0,12,442,99
1500000US530330225001,530330225001,"Block Group 1, Census Tract 225, King County, Washington",449,102,0,12,0,12,0,12,449,102,77,75,372,90
1500000US530330225002,530330225002,"Block Group 2, Census Tract 225, King County, Washington",530,85,0,12,0,12,0,12,530,85,78,67,452,92
1500000US530330225003,530330225003,"Block Group 3, Census Tract 225, King County, Washington",523,114,15,25,15,25,0,12,508,113,40,37,468,115
1500000US530330225004,530330225004,"Block Group 4, Census Tract 225, King County, Washington",875,126,14,23,0,12,14,23,861,128,193,94,668,115
1500000US530330225005,530330225005,"Block Group 5, Census Tract 225, King County, Washington",1063,129,18,30,0,12,18,30,1045,131,98,72,947,134
1500000US530330226031,530330226031,"Block Group 1, Census Tract 226.03, King County, Washington",255,101,9,15,0,12,9,15,246,104,48,54,198,93
1500000US530330226032,530330226032,"Block Group 2, Census Tract 226.03, King County, Washington",263,55,0,12,0,12,0,12,263,55,35,28,228,56
1500000US530330226033,530330226033,"Block Group 3, Census Tract 226.03, King County, Washington",305,66,0,12,0,12,0,12,305,66,63,57,242,66
1500000US530330226034,530330226034,"Block Group 4, Census Tract 226.03, King County, Washington",591,74,27,42,0,12,27,42,564,76,90,56,474,84
1500000US530330226035,530330226035,"Block Group 5, Census Tract 226.03, King County, Washington",481,106,12,18,0,12,12,18,469,111,41,32,428,118
1500000US530330226041,530330226041,"Block Group 1, Census Tract 226.04, King County, Washington",515,68,6,10,0,12,6,10,509,67,39,25,470,72
1500000US530330226042,530330226042,"Block Group 2, Census Tract 226.04, King County, Washington",549,65,30,48,30,48,0,12,519,77,108,45,411,82
1500000US530330226043,530330226043,"Block Group 3, Census Tract 226.04, King County, Washington",488,58,16,18,16,18,0,12,472,62,28,25,444,61
1500000US530330226051,530330226051,"Block Group 1, Census Tract 226.05, King County, Washington",1146,138,102,90,13,23,89,87,1044,150,180,99,864,153
1500000US530330226052,530330226052,"Block Group 2, Census Tract 226.05, King County, Washington",582,98,15,23,15,23,0,12,567,98,102,73,465,101
1500000US530330226053,530330226053,"Block Group 3, Census Tract 226.05, King County, Washington",781,148,24,29,11,19,13,21,757,148,123,102,634,144
1500000US530330226061,530330226061,"Block Group 1, Census Tract 226.06, King County, Washington",543,142,0,12,0,12,0,12,543,142,232,124,311,115
1500000US530330226062,530330226062,"Block Group 2, Census Tract 226.06, King County, Washington",578,110,43,56,0,12,43,56,535,112,19,23,516,115
1500000US530330226063,530330226063,"Block Group 3, Census Tract 226.06, King County, Washington",706,121,32,36,14,22,18,30,674,128,52,39,622,127
1500000US530330226064,530330226064,"Block Group 4, Census Tract 226.06, King County, Washington",458,91,0,12,0,12,0,12,458,91,131,60,327,88
1500000US530330227011,530330227011,"Block Group 1, Census Tract 227.01, King County, Washington",742,86,0,12,0,12,0,12,742,86,140,52,602,87
1500000US530330227012,530330227012,"Block Group 2, Census Tract 227.01, King County, Washington",618,88,8,12,0,12,8,12,610,88,28,33,582,89
1500000US530330227021,530330227021,"Block Group 1, Census Tract 227.02, King County, Washington",612,70,0,12,0,12,0,12,612,70,56,38,556,83
1500000US530330227022,530330227022,"Block Group 2, Census Tract 227.02, King County, Washington",289,59,34,33,0,12,34,33,255,64,22,23,233,64
1500000US530330227023,530330227023,"Block Group 3, Census Tract 227.02, King County, Washington",382,53,14,21,14,21,0,12,368,53,34,22,334,57
1500000US530330227031,530330227031,"Block Group 1, Census Tract 227.03, King County, Washington",495,48,11,12,0,12,11,12,484,48,65,30,419,55
1500000US530330227032,530330227032,"Block Group 2, Census Tract 227.03, King County, Washington",284,43,22,21,20,20,2,5,262,44,24,20,238,43
1500000US530330228011,530330228011,"Block Group 1, Census Tract 228.01, King County, Washington",1425,164,14,22,0,12,14,22,1411,164,74,51,1337,170
1500000US530330228012,530330228012,"Block Group 2, Census Tract 228.01, King County, Washington",1302,167,65,58,22,26,43,50,1237,173,28,30,1209,173
1500000US530330228013,530330228013,"Block Group 3, Census Tract 228.01, King County, Washington",471,81,0,12,0,12,0,12,471,81,95,58,376,87
1500000US530330228014,530330228014,"Block Group 4, Census Tract 228.01, King County, Washington",669,124,49,37,30,25,19,30,620,117,13,20,607,116
1500000US530330228021,530330228021,"Block Group 1, Census Tract 228.02, King County, Washington",895,97,7,12,7,12,0,12,888,96,26,33,862,99
1500000US530330228022,530330228022,"Block Group 2, Census Tract 228.02, King County, Washington",617,102,14,19,14,19,0,12,603,105,80,53,523,102
1500000US530330228023,530330228023,"Block Group 3, Census Tract 228.02, King County, Washington",567,89,0,12,0,12,0,12,567,89,153,79,414,86
1500000US530330228031,530330228031,"Block Group 1, Census Tract 228.03, King County, Washington",282,90,0,12,0,12,0,12,282,90,28,42,254,92
1500000US530330228032,530330228032,"Block Group 2, Census Tract 228.03, King County, Washington",1142,137,8,13,0,12,8,13,1134,137,95,77,1039,154
1500000US530330228033,530330228033,"Block Group 3, Census Tract 228.03, King County, Washington",885,130,252,91,105,64,147,88,633,137,138,107,495,158
1500000US530330229011,530330229011,"Block Group 1, Census Tract 229.01, King County, Washington",592,65,24,25,6,12,18,24,568,68,78,37,490,77
1500000US530330229012,530330229012,"Block Group 2, Census Tract 229.01, King County, Washington",384,50,0,12,0,12,0,12,384,50,65,56,319,56
1500000US530330229021,530330229021,"Block Group 1, Census Tract 229.02, King County, Washington",629,85,0,12,0,12,0,12,629,85,22,27,607,87
1500000US530330229022,530330229022,"Block Group 2, Census Tract 229.02, King County, Washington",288,67,0,12,0,12,0,12,288,67,39,30,249,69
1500000US530330229023,530330229023,"Block Group 3, Census Tract 229.02, King County, Washington",308,87,23,36,0,12,23,36,285,87,174,83,111,45
1500000US530330229024,530330229024,"Block Group 4, Census Tract 229.02, King County, Washington",850,131,22,33,0,12,22,33,828,135,77,67,751,149
1500000US530330229025,530330229025,"Block Group 5, Census Tract 229.02, King County, Washington",472,93,12,20,0,12,12,20,460,98,72,75,388,87
1500000US530330230001,530330230001,"Block Group 1, Census Tract 230, King County, Washington",521,56,7,11,7,11,0,12,514,57,134,45,380,66
1500000US530330230002,530330230002,"Block Group 2, Census Tract 230, King County, Washington",358,61,8,13,0,12,8,13,350,63,55,32,295,63
1500000US530330230003,530330230003,"Block Group 3, Census Tract 230, King County, Washington",480,81,10,15,10,15,0,12,470,80,84,52,386,86
1500000US530330230004,530330230004,"Block Group 4, Census Tract 230, King County, Washington",446,70,8,12,8,12,0,12,438,72,70,36,368,78
1500000US530330231001,530330231001,"Block Group 1, Census Tract 231, King County, Washington",435,69,40,48,40,48,0,12,395,79,80,52,315,77
1500000US530330231002,530330231002,"Block Group 2, Census Tract 231, King County, Washington",353,60,28,25,9,13,19,20,325,59,52,32,273,60
1500000US530330231003,530330231003,"Block Group 3, Census Tract 231, King County, Washington",576,93,0,12,0,12,0,12,576,93,81,42,495,90
1500000US530330232011,530330232011,"Block Group 1, Census Tract 232.01, King County, Washington",448,89,0,12,0,12,0,12,448,89,145,66,303,91
1500000US530330232012,530330232012,"Block Group 2, Census Tract 232.01, King County, Washington",837,158,160,109,160,109,0,12,677,138,68,54,609,133
1500000US530330232013,530330232013,"Block Group 3, Census Tract 232.01, King County, Washington",1215,152,45,46,45,46,0,12,1170,154,157,97,1013,160
1500000US530330232021,530330232021,"Block Group 1, Census Tract 232.02, King County, Washington",751,99,175,69,147,67,28,27,576,88,97,46,479,90
1500000US530330232022,530330232022,"Block Group 2, Census Tract 232.02, King County, Washington",497,61,68,62,16,18,52,59,429,68,67,39,362,73
1500000US530330232023,530330232023,"Block Group 3, Census Tract 232.02, King County, Washington",512,87,66,57,29,36,37,44,446,85,28,19,418,86
1500000US530330233001,530330233001,"Block Group 1, Census Tract 233, King County, Washington",687,81,0,12,0,12,0,12,687,81,122,64,565,95
1500000US530330233002,530330233002,"Block Group 2, Census Tract 233, King County, Washington",415,66,49,63,0,12,49,63,366,78,32,31,334,84
1500000US530330233003,530330233003,"Block Group 3, Census Tract 233, King County, Washington",586,102,137,82,87,63,50,75,449,91,141,71,308,94
1500000US530330233004,530330233004,"Block Group 4, Census Tract 233, King County, Washington",522,64,62,64,0,12,62,64,460,74,133,73,327,80
1500000US530330234011,530330234011,"Block Group 1, Census Tract 234.01, King County, Washington",331,70,23,27,12,19,11,18,308,69,85,55,223,57
1500000US530330234012,530330234012,"Block Group 2, Census Tract 234.01, King County, Washington",660,89,45,38,32,36,13,21,615,81,77,40,538,91
1500000US530330234013,530330234013,"Block Group 3, Census Tract 234.01, King County, Washington",424,83,43,25,0,12,43,25,381,86,86,50,295,82
1500000US530330234031,530330234031,"Block Group 1, Census Tract 234.03, King County, Washington",692,98,8,13,0,12,8,13,684,100,62,50,622,108
1500000US530330234032,530330234032,"Block Group 2, Census Tract 234.03, King County, Washington",386,75,15,24,0,12,15,24,371,76,72,35,299,76
1500000US530330234033,530330234033,"Block Group 3, Census Tract 234.03, King County, Washington",479,88,8,12,0,12,8,12,471,88,35,35,436,81
1500000US530330234041,530330234041,"Block Group 1, Census Tract 234.04, King County, Washington",650,99,36,37,11,17,25,32,614,98,50,36,564,96
1500000US530330234042,530330234042,"Block Group 2, Census Tract 234.04, King County, Washington",511,82,27,28,27,28,0,12,484,83,30,27,454,83
1500000US530330235001,530330235001,"Block Group 1, Census Tract 235, King County, Washington",510,61,0,12,0,12,0,12,510,61,124,65,386,83
1500000US530330235002,530330235002,"Block Group 2, Census Tract 235, King County, Washington",430,80,9,13,9,13,0,12,421,81,45,27,376,83
1500000US530330235003,530330235003,"Block Group 3, Census Tract 235, King County, Washington",512,63,70,53,40,42,30,36,442,56,74,37,368,54
1500000US530330236011,530330236011,"Block Group 1, Census Tract 236.01, King County, Washington",600,93,41,27,7,11,34,25,559,90,128,52,431,82
1500000US530330236012,530330236012,"Block Group 2, Census Tract 236.01, King County, Washington",680,77,75,59,25,39,50,46,605,87,59,37,546,89
1500000US530330236013,530330236013,"Block Group 3, Census Tract 236.01, King County, Washington",329,53,0,12,0,12,0,12,329,53,39,23,290,56
1500000US530330236031,530330236031,"Block Group 1, Census Tract 236.03, King County, Washington",453,90,23,28,23,28,0,12,430,94,79,45,351,93
1500000US530330236032,530330236032,"Block Group 2, Census Tract 236.03, King County, Washington",950,128,25,29,12,19,13,22,925,127,48,38,877,132
1500000US530330236033,530330236033,"Block Group 3, Census Tract 236.03, King County, Washington",489,80,0,12,0,12,0,12,489,80,98,65,391,92
1500000US530330236034,530330236034,"Block Group 4, Census Tract 236.03, King County, Washington",519,91,94,65,19,21,75,62,425,101,136,88,289,118
1500000US530330236041,530330236041,"Block Group 1, Census Tract 236.04, King County, Washington",881,128,48,63,0,12,48,63,833,127,165,110,668,121
1500000US530330236042,530330236042,"Block Group 2, Census Tract 236.04, King County, Washington",360,85,84,66,20,32,64,59,276,87,70,55,206,91
1500000US530330236043,530330236043,"Block Group 3, Census Tract 236.04, King County, Washington",729,133,0,12,0,12,0,12,729,133,218,88,511,128
1500000US530330236044,530330236044,"Block Group 4, Census Tract 236.04, King County, Washington",494,108,58,65,0,12,58,65,436,100,106,92,330,97
1500000US530330237001,530330237001,"Block Group 1, Census Tract 237, King County, Washington",323,61,6,10,0,12,6,10,317,63,22,21,295,65
1500000US530330237002,530330237002,"Block Group 2, Census Tract 237, King County, Washington",657,71,27,25,6,16,21,23,630,71,71,38,559,79
1500000US530330237003,530330237003,"Block Group 3, Census Tract 237, King County, Washington",706,69,7,11,0,12,7,11,699,69,68,51,631,81
1500000US530330238011,530330238011,"Block Group 1, Census Tract 238.01, King County, Washington",735,81,10,15,10,15,0,12,725,82,73,33,652,83
1500000US530330238012,530330238012,"Block Group 2, Census Tract 238.01, King County, Washington",461,80,39,30,29,28,10,16,422,84,38,29,384,83
1500000US530330238031,530330238031,"Block Group 1, Census Tract 238.03, King County, Washington",1091,202,0,12,0,12,0,12,1091,202,160,133,931,193
1500000US530330238032,530330238032,"Block Group 2, Census Tract 238.03, King County, Washington",1189,238,54,50,54,50,0,12,1135,239,215,131,920,209
1500000US530330238041,530330238041,"Block Group 1, Census Tract 238.04, King County, Washington",916,162,71,45,51,39,20,35,845,166,104,65,741,169
1500000US530330238042,530330238042,"Block Group 2, Census Tract 238.04, King County, Washington",770,201,0,12,0,12,0,12,770,201,34,51,736,210
1500000US530330238043,530330238043,"Block Group 3, Census Tract 238.04, King County, Washington",1578,270,128,92,115,91,13,21,1450,276,88,97,1362,266
1500000US530330239001,530330239001,"Block Group 1, Census Tract 239, King County, Washington",940,153,67,46,27,23,40,40,873,152,117,57,756,147
1500000US530330239002,530330239002,"Block Group 2, Census Tract 239, King County, Washington",697,100,43,69,0,12,43,69,654,90,137,79,517,111
1500000US530330239003,530330239003,"Block Group 3, Census Tract 239, King County, Washington",676,87,15,23,14,23,1,3,661,84,62,46,599,97
1500000US530330239004,530330239004,"Block Group 4, Census Tract 239, King County, Washington",498,98,0,12,0,12,0,12,498,98,109,51,389,110
1500000US530330240001,530330240001,"Block Group 1, Census Tract 240, King County, Washington",735,119,14,24,14,24,0,12,721,121,48,45,673,122
1500000US530330240002,530330240002,"Block Group 2, Census Tract 240, King County, Washington",683,124,0,12,0,12,0,12,683,124,99,66,584,136
1500000US530330240003,530330240003,"Block Group 3, Census Tract 240, King County, Washington",988,160,0,12,0,12,0,12,988,160,136,88,852,161
1500000US530330240004,530330240004,"Block Group 4, Census Tract 240, King County, Washington",894,136,31,35,16,25,15,24,863,139,157,96,706,139
1500000US530330241001,530330241001,"Block Group 1, Census Tract 241, King County, Washington",387,38,0,12,0,12,0,12,387,38,59,18,328,39
1500000US530330241002,530330241002,"Block Group 2, Census Tract 241, King County, Washington",320,31,6,7,3,4,3,5,314,32,56,23,258,33
1500000US530330241003,530330241003,"Block Group 3, Census Tract 241, King County, Washington",497,44,0,12,0,12,0,12,497,44,84,27,413,51
1500000US530330241004,530330241004,"Block Group 4, Census Tract 241, King County, Washington",367,40,5,7,0,12,5,7,362,39,66,30,296,41
1500000US530330242001,530330242001,"Block Group 1, Census Tract 242, King County, Washington",464,58,0,12,0,12,0,12,464,58,46,22,418,58
1500000US530330242002,530330242002,"Block Group 2, Census Tract 242, King County, Washington",568,73,6,8,6,8,0,12,562,74,71,29,491,70
1500000US530330243001,530330243001,"Block Group 1, Census Tract 243, King County, Washington",450,93,14,23,0,12,14,23,436,94,22,27,414,92
1500000US530330243002,530330243002,"Block Group 2, Census Tract 243, King County, Washington",1249,162,17,26,0,12,17,26,1232,165,241,105,991,165
1500000US530330243003,530330243003,"Block Group 3, Census Tract 243, King County, Washington",482,123,4,14,0,12,4,14,478,122,71,51,407,125
1500000US530330243004,530330243004,"Block Group 4, Census Tract 243, King County, Washington",763,135,25,20,12,21,13,20,738,136,181,85,557,150
1500000US530330243005,530330243005,"Block Group 5, Census Tract 243, King County, Washington",478,110,16,25,0,12,16,25,462,112,17,26,445,113
1500000US530330244001,530330244001,"Block Group 1, Census Tract 244, King County, Washington",540,80,0,12,0,12,0,12,540,80,200,80,340,77
1500000US530330244002,530330244002,"Block Group 2, Census Tract 244, King County, Washington",830,88,8,18,0,12,8,18,822,86,78,53,744,92
1500000US530330245001,530330245001,"Block Group 1, Census Tract 245, King County, Washington",721,69,0,12,0,12,0,12,721,69,112,47,609,70
1500000US530330245002,530330245002,"Block Group 2, Census Tract 245, King County, Washington",515,69,9,14,9,14,0,12,506,70,77,41,429,79
1500000US530330245003,530330245003,"Block Group 3, Census Tract 245, King County, Washington",484,75,9,15,9,15,0,12,475,75,78,43,397,80
1500000US530330246011,530330246011,"Block Group 1, Census Tract 246.01, King County, Washington",562,78,9,13,9,13,0,12,553,77,156,72,397,76
1500000US530330246012,530330246012,"Block Group 2, Census Tract 246.01, King County, Washington",532,64,0,12,0,12,0,12,532,64,154,53,378,67
1500000US530330246013,530330246013,"Block Group 3, Census Tract 246.01, King County, Washington",552,79,0,12,0,12,0,12,552,79,69,58,483,84
1500000US530330246021,530330246021,"Block Group 1, Census Tract 246.02, King County, Washington",317,48,13,20,0,12,13,20,304,48,30,28,274,51
1500000US530330246022,530330246022,"Block Group 2, Census Tract 246.02, King County, Washington",707,59,0,12,0,12,0,12,707,59,91,37,616,66
1500000US530330246023,530330246023,"Block Group 3, Census Tract 246.02, King County, Washington",273,49,0,12,0,12,0,12,273,49,44,30,229,64
1500000US530330247011,530330247011,"Block Group 1, Census Tract 247.01, King County, Washington",479,74,33,32,6,10,27,31,446,82,61,47,385,87
1500000US530330247012,530330247012,"Block Group 2, Census Tract 247.01, King County, Washington",506,88,55,48,5,8,50,48,451,88,46,35,405,92
1500000US530330247013,530330247013,"Block Group 3, Census Tract 247.01, King County, Washington",328,71,13,15,7,11,6,10,315,74,47,37,268,78
1500000US530330247021,530330247021,"Block Group 1, Census Tract 247.02, King County, Washington",826,138,0,12,0,12,0,12,826,138,75,52,751,146
1500000US530330247022,530330247022,"Block Group 2, Census Tract 247.02, King County, Washington",402,77,37,55,0,12,37,55,365,67,42,39,323,64
1500000US530330247023,530330247023,"Block Group 3, Census Tract 247.02, King County, Washington",640,97,0,12,0,12,0,12,640,97,60,43,580,103
1500000US530330247024,530330247024,"Block Group 4, Census Tract 247.02, King County, Washington",542,94,0,12,0,12,0,12,542,94,43,40,499,96
1500000US530330247025,530330247025,"Block Group 5, Census Tract 247.02, King County, Washington",366,100,0,12,0,12,0,12,366,100,64,46,302,96
1500000US530330248001,530330248001,"Block Group 1, Census Tract 248, King County, Washington",446,86,19,31,19,31,0,12,427,88,48,43,379,96
1500000US530330248002,530330248002,"Block Group 2, Census Tract 248, King County, Washington",710,134,12,20,12,20,0,12,698,135,151,67,547,129
1500000US530330248003,530330248003,"Block Group 3, Census Tract 248, King County, Washington",1069,152,99,102,19,22,80,98,970,155,88,73,882,161
1500000US530330249011,530330249011,"Block Group 1, Census Tract 249.01, King County, Washington",383,64,43,30,12,18,31,23,340,68,100,70,240,57
1500000US530330249012,530330249012,"Block Group 2, Census Tract 249.01, King County, Washington",539,65,0,12,0,12,0,12,539,65,123,42,416,70
1500000US530330249013,530330249013,"Block Group 3, Census Tract 249.01, King County, Washington",465,63,11,17,11,17,0,12,454,63,16,19,438,66
1500000US530330249014,530330249014,"Block Group 4, Census Tract 249.01, King County, Washington",336,61,0,12,0,12,0,12,336,61,68,34,268,62
1500000US530330249021,530330249021,"Block Group 1, Census Tract 249.02, King County, Washington",401,60,0,12,0,12,0,12,401,60,60,33,341,70
1500000US530330249022,530330249022,"Block Group 2, Census Tract 249.02, King County, Washington",506,76,10,16,10,16,0,12,496,79,33,30,463,81
1500000US530330249023,530330249023,"Block Group 3, Census Tract 249.02, King County, Washington",431,75,37,32,37,32,0,12,394,81,41,34,353,88
1500000US530330249031,530330249031,"Block Group 1, Census Tract 249.03, King County, Washington",687,101,0,12,0,12,0,12,687,101,29,32,658,106
1500000US530330249032,530330249032,"Block Group 2, Census Tract 249.03, King County, Washington",528,75,0,12,0,12,0,12,528,75,67,45,461,79
1500000US530330249033,530330249033,"Block Group 3, Census Tract 249.03, King County, Washington",488,70,0,12,0,12,0,12,488,70,44,34,444,77
1500000US530330249034,530330249034,"Block Group 4, Census Tract 249.03, King County, Washington",501,70,10,18,0,12,10,18,491,74,78,40,413,79
1500000US530330250011,530330250011,"Block Group 1, Census Tract 250.01, King County, Washington",318,60,0,12,0,12,0,12,318,60,37,30,281,61
1500000US530330250012,530330250012,"Block Group 2, Census Tract 250.01, King County, Washington",615,90,39,49,0,12,39,49,576,89,59,40,517,90
1500000US530330250013,530330250013,"Block Group 3, Census Tract 250.01, King County, Washington",428,71,35,25,10,17,25,23,393,71,97,62,296,73
1500000US530330250014,530330250014,"Block Group 4, Census Tract 250.01, King County, Washington",365,62,27,25,0,12,27,25,338,65,46,26,292,66
1500000US530330250031,530330250031,"Block Group 1, Census Tract 250.03, King County, Washington",474,85,0,12,0,12,0,12,474,85,44,35,430,87
1500000US530330250032,530330250032,"Block Group 2, Census Tract 250.03, King County, Washington",376,87,61,76,0,12,61,76,315,75,12,20,303,75
1500000US530330250033,530330250033,"Block Group 3, Census Tract 250.03, King County, Washington",616,103,29,34,15,24,14,23,587,97,79,65,508,105
1500000US530330250034,530330250034,"Block Group 4, Census Tract 250.03, King County, Washington",488,112,15,23,0,12,15,23,473,119,34,36,439,118
1500000US530330250035,530330250035,"Block Group 5, Census Tract 250.03, King County, Washington",591,128,0,12,0,12,0,12,591,128,81,61,510,142
1500000US530330250051,530330250051,"Block Group 1, Census Tract 250.05, King County, Washington",973,89,15,20,0,12,15,20,958,93,38,33,920,102
1500000US530330250052,530330250052,"Block Group 2, Census Tract 250.05, King County, Washington",880,124,55,52,55,52,0,12,825,129,131,76,694,134
1500000US530330250061,530330250061,"Block Group 1, Census Tract 250.06, King County, Washington",514,97,27,40,0,12,27,40,487,105,11,18,476,104
1500000US530330250062,530330250062,"Block Group 2, Census Tract 250.06, King County, Washington",1079,140,32,54,32,54,0,12,1047,126,210,93,837,129
1500000US530330250063,530330250063,"Block Group 3, Census Tract 250.06, King County, Washington",430,101,0,12,0,12,0,12,430,101,23,28,407,101
1500000US530330251011,530330251011,"Block Group 1, Census Tract 251.01, King County, Washington",658,119,266,103,75,65,191,107,392,112,61,67,331,114
1500000US530330251012,530330251012,"Block Group 2, Census Tract 251.01, King County, Washington",526,128,152,96,71,66,81,78,374,99,66,45,308,107
1500000US530330251013,530330251013,"Block Group 3, Census Tract 251.01, King County, Washington",258,77,0,12,0,12,0,12,258,77,0,12,258,77
1500000US530330251014,530330251014,"Block Group 4, Census Tract 251.01, King County, Washington",714,95,29,35,10,17,19,30,685,110,43,38,642,115
1500000US530330251021,530330251021,"Block Group 1, Census Tract 251.02, King County, Washington",518,88,41,41,0,12,41,41,477,99,51,50,426,104
1500000US530330251022,530330251022,"Block Group 2, Census Tract 251.02, King County, Washington",541,161,59,80,0,12,59,80,482,136,38,37,444,131
1500000US530330251023,530330251023,"Block Group 3, Census Tract 251.02, King County, Washington",1110,158,79,62,0,12,79,62,1031,172,137,68,894,158
1500000US530330251024,530330251024,"Block Group 4, Census Tract 251.02, King County, Washington",545,126,0,12,0,12,0,12,545,126,115,75,430,121
1500000US530330252001,530330252001,"Block Group 1, Census Tract 252, King County, Washington",457,132,18,28,18,28,0,12,439,132,34,36,405,134
1500000US530330252002,530330252002,"Block Group 2, Census Tract 252, King County, Washington",881,115,105,81,66,68,39,41,776,111,136,67,640,114
1500000US530330252003,530330252003,"Block Group 3, Census Tract 252, King County, Washington",569,116,97,56,40,50,57,62,472,123,92,50,380,126
1500000US530330252004,530330252004,"Block Group 4, Census Tract 252, King County, Washington",761,118,213,84,147,74,66,48,548,91,112,56,436,98
1500000US530330252005,530330252005,"Block Group 5, Census Tract 252, King County, Washington",461,94,54,39,10,17,44,35,407,97,58,56,349,92
1500000US530330253011,530330253011,"Block Group 1, Census Tract 253.01, King County, Washington",744,154,29,33,14,22,15,26,715,161,54,43,661,162
1500000US530330253012,530330253012,"Block Group 2, Census Tract 253.01, King County, Washington",713,142,30,37,0,12,30,37,683,138,58,71,625,137
1500000US530330253013,530330253013,"Block Group 3, Census Tract 253.01, King County, Washington",840,160,99,74,12,19,87,73,741,154,120,62,621,156
1500000US530330253021,530330253021,"Block Group 1, Census Tract 253.02, King County, Washington",1232,182,114,109,114,109,0,12,1118,176,302,121,816,164
1500000US530330253022,530330253022,"Block Group 2, Census Tract 253.02, King County, Washington",912,164,0,12,0,12,0,12,912,164,179,75,733,168
1500000US530330253023,530330253023,"Block Group 3, Census Tract 253.02, King County, Washington",501,140,170,92,91,80,79,49,331,128,29,27,302,129
1500000US530330254001,530330254001,"Block Group 1, Census Tract 254, King County, Washington",547,117,50,59,50,59,0,12,497,117,150,69,347,109
1500000US530330254002,530330254002,"Block Group 2, Census Tract 254, King County, Washington",758,165,204,99,67,53,137,90,554,141,39,41,515,134
1500000US530330254003,530330254003,"Block Group 3, Census Tract 254, King County, Washington",1171,224,170,98,59,51,111,85,1001,241,149,69,852,240
1500000US530330254004,530330254004,"Block Group 4, Census Tract 254, King County, Washington",516,148,61,67,0,12,61,67,455,143,35,39,420,141
1500000US530330255001,530330255001,"Block Group 1, Census Tract 255, King County, Washington",866,108,131,68,71,47,60,49,735,111,91,63,644,121
1500000US530330255002,530330255002,"Block Group 2, Census Tract 255, King County, Washington",491,80,60,42,9,15,51,40,431,84,170,66,261,72
1500000US530330255003,530330255003,"Block Group 3, Census Tract 255, King County, Washington",526,73,73,59,65,57,8,13,453,78,89,50,364,80
1500000US530330256011,530330256011,"Block Group 1, Census Tract 256.01, King County, Washington",380,89,22,29,10,16,12,21,358,91,39,38,319,88
1500000US530330256012,530330256012,"Block Group 2, Census Tract 256.01, King County, Washington",966,121,119,93,73,77,46,59,847,125,183,77,664,154
1500000US530330256013,530330256013,"Block Group 3, Census Tract 256.01, King County, Washington",577,94,59,50,0,12,59,50,518,96,79,51,439,105
1500000US530330256021,530330256021,"Block Group 1, Census Tract 256.02, King County, Washington",781,100,95,61,27,31,68,53,686,114,98,49,588,113
1500000US530330256022,530330256022,"Block Group 2, Census Tract 256.02, King County, Washington",456,77,29,33,11,18,18,29,427,81,77,47,350,88
1500000US530330256023,530330256023,"Block Group 3, Census Tract 256.02, King County, Washington",844,92,31,29,7,12,24,27,813,97,125,54,688,105
1500000US530330257011,530330257011,"Block Group 1, Census Tract 257.01, King County, Washington",383,90,57,48,13,21,44,42,326,77,40,37,286,72
1500000US530330257012,530330257012,"Block Group 2, Census Tract 257.01, King County, Washington",615,113,140,102,81,86,59,70,475,121,81,64,394,111
1500000US530330257013,530330257013,"Block Group 3, Census Tract 257.01, King County, Washington",417,145,226,108,128,101,98,76,191,96,49,54,142,82
1500000US530330257014,530330257014,"Block Group 4, Census Tract 257.01, King County, Washington",429,128,15,26,0,12,15,26,414,123,88,76,326,107
1500000US530330257015,530330257015,"Block Group 5, Census Tract 257.01, King County, Washington",776,157,124,72,12,20,112,71,652,169,112,65,540,163
1500000US530330257021,530330257021,"Block Group 1, Census Tract 257.02, King County, Washington",471,74,19,29,0,12,19,29,452,76,78,66,374,94
1500000US530330257022,530330257022,"Block Group 2, Census Tract 257.02, King County, Washington",416,69,0,12,0,12,0,12,416,69,76,45,340,77
1500000US530330257023,530330257023,"Block Group 3, Census Tract 257.02, King County, Washington",384,72,37,32,25,27,12,18,347,73,78,40,269,81
1500000US530330258031,530330258031,"Block Group 1, Census Tract 258.03, King County, Washington",517,93,54,44,0,12,54,44,463,102,79,59,384,85
1500000US530330258032,530330258032,"Block Group 2, Census Tract 258.03, King County, Washington",602,95,115,61,28,24,87,57,487,101,127,77,360,97
1500000US530330258033,530330258033,"Block Group 3, Census Tract 258.03, King County, Washington",583,94,272,102,120,84,152,83,311,97,48,45,263,91
1500000US530330258041,530330258041,"Block Group 1, Census Tract 258.04, King County, Washington",523,93,40,35,30,32,10,17,483,94,122,50,361,87
1500000US530330258042,530330258042,"Block Group 2, Census Tract 258.04, King County, Washington",374,73,28,25,18,20,10,15,346,73,36,28,310,75
1500000US530330258043,530330258043,"Block Group 3, Census Tract 258.04, King County, Washington",370,74,49,48,23,26,26,41,321,79,41,32,280,83
1500000US530330258051,530330258051,"Block Group 1, Census Tract 258.05, King County, Washington",863,142,192,108,52,80,140,86,671,136,155,90,516,117
1500000US530330258052,530330258052,"Block Group 2, Census Tract 258.05, King County, Washington",326,77,10,16,10,16,0,12,316,77,52,34,264,75
1500000US530330258053,530330258053,"Block Group 3, Census Tract 258.05, King County, Washington",631,115,72,51,54,47,18,21,559,113,107,91,452,115
1500000US530330258061,530330258061,"Block Group 1, Census Tract 258.06, King County, Washington",446,81,0,12,0,12,0,12,446,81,76,50,370,84
1500000US530330258062,530330258062,"Block Group 2, Census Tract 258.06, King County, Washington",749,130,63,62,9,13,54,61,686,136,88,69,598,131
1500000US530330258063,530330258063,"Block Group 3, Census Tract 258.06, King County, Washington",531,96,169,87,67,66,102,65,362,85,39,28,323,84
1500000US530330260011,530330260011,"Block Group 1, Census Tract 260.01, King County, Washington",629,125,43,35,0,12,43,35,586,128,80,59,506,125
1500000US530330260012,530330260012,"Block Group 2, Census Tract 260.01, King County, Washington",293,86,50,52,18,21,32,48,243,82,74,64,169,70
1500000US530330260013,530330260013,"Block Group 3, Census Tract 260.01, King County, Washington",552,116,30,38,0,12,30,38,522,127,92,59,430,137
1500000US530330260014,530330260014,"Block Group 4, Census Tract 260.01, King County, Washington",359,90,82,70,46,53,36,57,277,64,78,44,199,69
1500000US530330260015,530330260015,"Block Group 5, Census Tract 260.01, King County, Washington",364,104,91,75,42,46,49,53,273,83,69,47,204,68
1500000US530330260021,530330260021,"Block Group 1, Census Tract 260.02, King County, Washington",1186,186,445,148,88,59,357,152,741,164,74,81,667,179
1500000US530330260022,530330260022,"Block Group 2, Census Tract 260.02, King County, Washington",632,138,115,75,21,28,94,67,517,150,157,81,360,133
1500000US530330260023,530330260023,"Block Group 3, Census Tract 260.02, King County, Washington",608,137,71,78,20,22,51,82,537,112,133,70,404,125
1500000US530330260024,530330260024,"Block Group 4, Census Tract 260.02, King County, Washington",698,145,43,51,15,25,28,44,655,151,101,82,554,144
1500000US530330261001,530330261001,"Block Group 1, Census Tract 261, King County, Washington",458,128,42,48,41,47,1,20,416,131,155,90,261,117
1500000US530330261002,530330261002,"Block Group 2, Census Tract 261, King County, Washington",439,172,96,89,34,41,62,78,343,154,129,108,214,131
1500000US530330261003,530330261003,"Block Group 3, Census Tract 261, King County, Washington",585,137,173,100,158,103,15,24,412,108,82,70,330,101
1500000US530330261004,530330261004,"Block Group 4, Census Tract 261, King County, Washington",511,143,152,93,16,27,136,99,359,132,34,41,325,126
1500000US530330261005,530330261005,"Block Group 5, Census Tract 261, King County, Washington",733,177,134,110,28,31,106,109,599,170,60,77,539,169
1500000US530330262001,530330262001,"Block Group 1, Census Tract 262, King County, Washington",32,29,0,12,0,12,0,12,32,29,0,12,32,29
1500000US530330262002,530330262002,"Block Group 2, Census Tract 262, King County, Washington",600,157,76,68,13,21,63,64,524,151,72,71,452,141
1500000US530330262003,530330262003,"Block Group 3, Census Tract 262, King County, Washington",937,180,397,169,130,123,267,148,540,129,87,57,453,132
1500000US530330262004,530330262004,"Block Group 4, Census Tract 262, King County, Washington",782,190,145,101,79,84,66,62,637,160,201,147,436,115
1500000US530330263001,530330263001,"Block Group 1, Census Tract 263, King County, Washington",188,59,0,12,0,12,0,12,188,59,56,33,132,60
1500000US530330263002,530330263002,"Block Group 2, Census Tract 263, King County, Washington",370,63,68,51,35,27,33,44,302,69,52,38,250,73
1500000US530330264001,530330264001,"Block Group 1, Census Tract 264, King County, Washington",204,66,5,10,5,10,0,12,199,68,27,25,172,71
1500000US530330264002,530330264002,"Block Group 2, Census Tract 264, King County, Washington",577,137,279,106,74,77,205,98,298,96,71,79,227,86
1500000US530330264003,530330264003,"Block Group 3, Census Tract 264, King County, Washington",407,116,38,47,9,17,29,40,369,115,102,52,267,110
1500000US530330264004,530330264004,"Block Group 4, Census Tract 264, King County, Washington",663,136,30,36,30,36,0,12,633,140,127,83,506,144
1500000US530330264005,530330264005,"Block Group 5, Census Tract 264, King County, Washington",525,144,231,127,122,113,109,78,294,127,23,20,271,136
1500000US530330265001,530330265001,"Block Group 1, Census Tract 265, King County, Washington",205,71,111,58,55,52,56,36,94,69,16,26,78,65
1500000US530330265002,530330265002,"Block Group 2, Census Tract 265, King County, Washington",592,123,408,105,97,44,311,102,184,84,30,34,154,80
1500000US530330265003,530330265003,"Block Group 3, Census Tract 265, King County, Washington",685,100,182,96,102,84,80,45,503,95,80,49,423,100
1500000US530330266001,530330266001,"Block Group 1, Census Tract 266, King County, Washington",465,73,88,46,17,15,71,42,377,67,35,25,342,67
1500000US530330266002,530330266002,"Block Group 2, Census Tract 266, King County, Washington",432,80,78,50,29,24,49,43,354,75,62,42,292,72
1500000US530330267001,530330267001,"Block Group 1, Census Tract 267, King County, Washington",516,121,39,49,39,49,0,12,477,116,109,65,368,109
1500000US530330267002,530330267002,"Block Group 2, Census Tract 267, King County, Washington",709,143,93,60,13,22,80,56,616,152,109,97,507,139
1500000US530330267003,530330267003,"Block Group 3, Census Tract 267, King County, Washington",460,68,15,24,0,12,15,24,445,72,124,61,321,67
1500000US530330267004,530330267004,"Block Group 4, Census Tract 267, King County, Washington",352,63,0,12,0,12,0,12,352,63,62,46,290,62
1500000US530330268011,530330268011,"Block Group 1, Census Tract 268.01, King County, Washington",393,89,30,31,30,31,0,12,363,89,178,75,185,67
1500000US530330268012,530330268012,"Block Group 2, Census Tract 268.01, King County, Washington",784,134,246,110,110,75,136,91,538,118,97,52,441,119
1500000US530330268013,530330268013,"Block Group 3, Census Tract 268.01, King County, Washington",495,125,248,93,79,58,169,94,247,91,7,11,240,91
1500000US530330268014,530330268014,"Block Group 4, Census Tract 268.01, King County, Washington",495,112,161,92,101,73,60,59,334,118,61,61,273,111
1500000US530330268021,530330268021,"Block Group 1, Census Tract 268.02, King County, Washington",276,81,40,25,24,21,16,19,236,84,46,38,190,78
1500000US530330268022,530330268022,"Block Group 2, Census Tract 268.02, King County, Washington",315,91,112,74,26,35,86,70,203,88,21,19,182,87
1500000US530330268023,530330268023,"Block Group 3, Census Tract 268.02, King County, Washington",495,98,141,66,83,50,58,47,354,95,108,56,246,86
1500000US530330268024,530330268024,"Block Group 4, Census Tract 268.02, King County, Washington",457,87,89,77,0,12,89,77,368,85,87,44,281,81
1500000US530330270001,530330270001,"Block Group 1, Census Tract 270, King County, Washington",248,63,65,51,33,25,32,43,183,54,52,32,131,53
1500000US530330270002,530330270002,"Block Group 2, Census Tract 270, King County, Washington",350,62,59,42,25,24,34,30,291,64,44,35,247,65
1500000US530330270003,530330270003,"Block Group 3, Census Tract 270, King County, Washington",448,69,74,47,15,24,59,46,374,66,63,42,311,69
1500000US530330271001,530330271001,"Block Group 1, Census Tract 271, King County, Washington",579,117,192,97,155,91,37,31,387,106,170,96,217,71
1500000US530330271002,530330271002,"Block Group 2, Census Tract 271, King County, Washington",618,100,155,80,48,41,107,77,463,121,47,36,416,119
1500000US530330272001,530330272001,"Block Group 1, Census Tract 272, King County, Washington",413,70,82,36,13,14,69,35,331,68,27,17,304,68
1500000US530330272002,530330272002,"Block Group 2, Census Tract 272, King County, Washington",493,73,130,65,45,36,85,55,363,90,96,47,267,86
1500000US530330273001,530330273001,"Block Group 1, Census Tract 273, King County, Washington",406,75,21,19,14,16,7,10,385,80,47,32,338,81
1500000US530330273002,530330273002,"Block Group 2, Census Tract 273, King County, Washington",772,102,425,127,186,98,239,104,347,103,82,59,265,94
1500000US530330273003,530330273003,"Block Group 3, Census Tract 273, King County, Washington",424,89,92,69,35,34,57,60,332,85,39,25,293,92
1500000US530330273004,530330273004,"Block Group 4, Census Tract 273, King County, Washington",405,81,103,53,76,47,27,22,302,83,101,49,201,74
1500000US530330274001,530330274001,"Block Group 1, Census Tract 274, King County, Washington",532,81,137,60,104,56,33,29,395,69,116,43,279,70
1500000US530330274002,530330274002,"Block Group 2, Census Tract 274, King County, Washington",345,96,99,66,34,38,65,49,246,75,63,39,183,73
1500000US530330274003,530330274003,"Block Group 3, Census Tract 274, King County, Washington",434,70,68,34,53,33,15,16,366,70,87,37,279,76
1500000US530330274004,530330274004,"Block Group 4, Census Tract 274, King County, Washington",257,62,39,32,6,10,33,35,218,65,38,29,180,67
1500000US530330275001,530330275001,"Block Group 1, Census Tract 275, King County, Washington",552,85,154,76,85,58,69,65,398,88,111,45,287,89
1500000US530330275002,530330275002,"Block Group 2, Census Tract 275, King County, Washington",365,69,26,25,10,17,16,19,339,69,86,49,253,67
1500000US530330275003,530330275003,"Block Group 3, Census Tract 275, King County, Washington",467,95,78,65,48,51,30,39,389,98,113,80,276,80
1500000US530330275004,530330275004,"Block Group 4, Census Tract 275, King County, Washington",280,51,10,15,0,12,10,15,270,52,30,24,240,51
1500000US530330276001,530330276001,"Block Group 1, Census Tract 276, King County, Washington",363,76,50,39,20,30,30,25,313,79,83,61,230,69
1500000US530330276002,530330276002,"Block Group 2, Census Tract 276, King County, Washington",895,92,337,98,121,64,216,94,558,114,117,61,441,108
1500000US530330276003,530330276003,"Block Group 3, Census Tract 276, King County, Washington",366,62,0,12,0,12,0,12,366,62,58,32,308,68
1500000US530330277011,530330277011,"Block Group 1, Census Tract 277.01, King County, Washington",566,114,29,34,29,34,0,12,537,126,109,68,428,129
1500000US530330277012,530330277012,"Block Group 2, Census Tract 277.01, King County, Washington",396,110,0,12,0,12,0,12,396,110,11,19,385,112
1500000US530330277013,530330277013,"Block Group 3, Census Tract 277.01, King County, Washington",674,190,32,37,20,29,12,18,642,198,118,132,524,181
1500000US530330277014,530330277014,"Block Group 4, Census Tract 277.01, King County, Washington",675,159,0,12,0,12,0,12,675,159,191,141,484,144
1500000US530330277015,530330277015,"Block Group 5, Census Tract 277.01, King County, Washington",598,155,0,12,0,12,0,12,598,155,44,39,554,163
1500000US530330277021,530330277021,"Block Group 1, Census Tract 277.02, King County, Washington",434,121,0,12,0,12,0,12,434,121,59,45,375,118
1500000US530330277022,530330277022,"Block Group 2, Census Tract 277.02, King County, Washington",612,149,13,20,13,20,0,12,599,151,77,71,522,144
1500000US530330277023,530330277023,"Block Group 3, Census Tract 277.02, King County, Washington",577,115,26,39,0,12,26,39,551,113,137,83,414,118
1500000US530330277024,530330277024,"Block Group 4, Census Tract 277.02, King County, Washington",608,108,0,12,0,12,0,12,608,108,142,72,466,96
1500000US530330278001,530330278001,"Block Group 1, Census Tract 278, King County, Washington",374,56,41,42,17,19,24,38,333,52,95,42,238,49
1500000US530330278002,530330278002,"Block Group 2, Census Tract 278, King County, Washington",447,74,13,17,13,17,0,12,434,71,66,36,368,79
1500000US530330278003,530330278003,"Block Group 3, Census Tract 278, King County, Washington",435,59,7,10,7,10,0,12,428,60,116,60,312,57
1500000US530330279001,530330279001,"Block Group 1, Census Tract 279, King County, Washington",550,130,83,50,50,42,33,37,467,132,165,113,302,99
1500000US530330279002,530330279002,"Block Group 2, Census Tract 279, King County, Washington",626,130,127,65,49,47,78,57,499,141,125,63,374,135
1500000US530330279003,530330279003,"Block Group 3, Census Tract 279, King County, Washington",619,141,208,147,70,73,138,130,411,140,87,67,324,132
1500000US530330279004,530330279004,"Block Group 4, Census Tract 279, King County, Washington",355,89,14,22,0,12,14,22,341,94,74,48,267,85
1500000US530330279005,530330279005,"Block Group 5, Census Tract 279, King County, Washington",278,76,55,60,39,55,16,27,223,69,53,37,170,67
1500000US530330279006,530330279006,"Block Group 6, Census Tract 279, King County, Washington",556,101,10,16,10,16,0,12,546,102,75,51,471,111
1500000US530330280001,530330280001,"Block Group 1, Census Tract 280, King County, Washington",537,102,55,41,11,13,44,37,482,110,51,38,431,116
1500000US530330280002,530330280002,"Block Group 2, Census Tract 280, King County, Washington",387,90,116,62,69,51,47,45,271,85,14,15,257,87
1500000US530330280003,530330280003,"Block Group 3, Census Tract 280, King County, Washington",459,90,146,65,129,67,17,17,313,71,62,49,251,80
1500000US530330281001,530330281001,"Block Group 1, Census Tract 281, King County, Washington",360,74,126,52,49,30,77,42,234,71,62,29,172,70
1500000US530330281002,530330281002,"Block Group 2, Census Tract 281, King County, Washington",408,77,72,56,57,59,15,14,336,77,83,44,253,72
1500000US530330282001,530330282001,"Block Group 1, Census Tract 282, King County, Washington",645,116,139,74,46,48,93,59,506,112,109,71,397,101
1500000US530330282002,530330282002,"Block Group 2, Census Tract 282, King County, Washington",590,103,102,63,51,49,51,41,488,100,67,36,421,98
1500000US530330282003,530330282003,"Block Group 3, Census Tract 282, King County, Washington",590,141,188,91,51,32,137,90,402,135,69,69,333,123
1500000US530330283001,530330283001,"Block Group 1, Census Tract 283, King County, Washington",449,92,78,60,17,21,61,65,371,74,80,43,291,71
1500000US530330283002,530330283002,"Block Group 2, Census Tract 283, King County, Washington",646,100,98,76,54,54,44,55,548,115,99,68,449,124
1500000US530330283003,530330283003,"Block Group 3, Census Tract 283, King County, Washington",815,123,53,67,13,21,40,64,762,127,59,36,703,127
1500000US530330284021,530330284021,"Block Group 1, Census Tract 284.02, King County, Washington",306,88,127,77,67,58,60,52,179,73,69,55,110,53
1500000US530330284022,530330284022,"Block Group 2, Census Tract 284.02, King County, Washington",347,111,62,59,12,19,50,58,285,87,80,47,205,82
1500000US530330284023,530330284023,"Block Group 3, Census Tract 284.02, King County, Washington",628,100,114,79,29,31,85,66,514,95,84,45,430,97
1500000US530330284024,530330284024,"Block Group 4, Census Tract 284.02, King County, Washington",482,114,87,73,0,12,87,73,395,123,72,66,323,116
1500000US530330284031,530330284031,"Block Group 1, Census Tract 284.03, King County, Washington",1249,152,215,97,32,37,183,94,1034,168,172,119,862,192
1500000US530330284032,530330284032,"Block Group 2, Census Tract 284.03, King County, Washington",728,129,106,67,69,55,37,37,622,135,295,124,327,111
1500000US530330284033,530330284033,"Block Group 3, Census Tract 284.03, King County, Washington",433,101,22,33,0,12,22,33,411,94,82,65,329,99
1500000US530330285001,530330285001,"Block Group 1, Census Tract 285, King County, Washington",352,65,28,28,6,12,22,25,324,63,34,31,290,61
1500000US530330285002,530330285002,"Block Group 2, Census Tract 285, King County, Washington",506,95,57,28,57,28,0,12,449,94,96,59,353,77
1500000US530330285003,530330285003,"Block Group 3, Census Tract 285, King County, Washington",719,115,190,96,55,50,135,85,529,104,117,74,412,97
1500000US530330286001,530330286001,"Block Group 1, Census Tract 286, King County, Washington",310,90,0,12,0,12,0,12,310,90,79,48,231,87
1500000US530330286002,530330286002,"Block Group 2, Census Tract 286, King County, Washington",395,108,0,12,0,12,0,12,395,108,139,84,256,86
1500000US530330286003,530330286003,"Block Group 3, Census Tract 286, King County, Washington",468,102,28,39,0,12,28,39,440,95,144,68,296,91
1500000US530330286004,530330286004,"Block Group 4, Census Tract 286, King County, Washington",516,85,74,63,0,12,74,63,442,86,60,50,382,87
1500000US530330286005,530330286005,"Block Group 5, Census Tract 286, King County, Washington",506,107,45,70,45,70,0,12,461,85,112,57,349,86
1500000US530330286006,530330286006,"Block Group 6, Census Tract 286, King County, Washington",424,94,87,76,19,29,68,70,337,91,111,50,226,87
1500000US530330287001,530330287001,"Block Group 1, Census Tract 287, King County, Washington",350,70,28,29,28,29,0,12,322,73,67,38,255,76
1500000US530330287002,530330287002,"Block Group 2, Census Tract 287, King County, Washington",445,85,0,12,0,12,0,12,445,85,63,39,382,89
1500000US530330287003,530330287003,"Block Group 3, Census Tract 287, King County, Washington",620,84,97,72,29,25,68,66,523,84,88,59,435,86
1500000US530330287004,530330287004,"Block Group 4, Census Tract 287, King County, Washington",474,89,0,12,0,12,0,12,474,89,139,66,335,87
1500000US530330288011,530330288011,"Block Group 1, Census Tract 288.01, King County, Washington",499,81,41,33,15,22,26,30,458,81,145,61,313,72
1500000US530330288012,530330288012,"Block Group 2, Census Tract 288.01, King County, Washington",352,66,39,35,0,12,39,35,313,71,85,44,228,68
1500000US530330288013,530330288013,"Block Group 3, Census Tract 288.01, King County, Washington",47,24,8,13,8,13,0,12,39,26,6,12,33,24
1500000US530330288021,530330288021,"Block Group 1, Census Tract 288.02, King County, Washington",770,155,183,116,73,68,110,93,587,140,92,63,495,140
1500000US530330288022,530330288022,"Block Group 2, Census Tract 288.02, King County, Washington",530,107,79,65,58,63,21,35,451,102,41,31,410,106
1500000US530330288023,530330288023,"Block Group 3, Census Tract 288.02, King County, Washington",362,146,180,101,73,89,107,76,182,111,0,12,182,111
1500000US530330288024,530330288024,"Block Group 4, Census Tract 288.02, King County, Washington",590,178,165,95,24,38,141,89,425,153,84,69,341,140
1500000US530330289011,530330289011,"Block Group 1, Census Tract 289.01, King County, Washington",509,84,57,38,9,13,48,38,452,88,100,52,352,76
1500000US530330289012,530330289012,"Block Group 2, Census Tract 289.01, King County, Washington",244,57,11,17,0,12,11,17,233,60,91,50,142,44
1500000US530330289013,530330289013,"Block Group 3, Census Tract 289.01, King County, Washington",336,69,0,12,0,12,0,12,336,69,123,54,213,65
1500000US530330289014,530330289014,"Block Group 4, Census Tract 289.01, King County, Washington",388,84,48,38,12,19,36,33,340,75,27,24,313,74
1500000US530330289021,530330289021,"Block Group 1, Census Tract 289.02, King County, Washington",239,109,121,101,121,101,0,12,118,77,52,64,66,44
1500000US530330289022,530330289022,"Block Group 2, Census Tract 289.02, King County, Washington",572,139,71,60,56,56,15,23,501,138,99,59,402,149
1500000US530330289023,530330289023,"Block Group 3, Census Tract 289.02, King County, Washington",518,143,250,136,36,36,214,132,268,113,96,68,172,98
1500000US530330289024,530330289024,"Block Group 4, Census Tract 289.02, King County, Washington",496,107,71,73,41,64,30,34,425,103,71,57,354,97
1500000US530330289025,530330289025,"Block Group 5, Census Tract 289.02, King County, Washington",524,161,179,118,106,93,73,81,345,129,88,75,257,122
1500000US530330290011,530330290011,"Block Group 1, Census Tract 290.01, King County, Washington",346,62,26,25,16,18,10,16,320,64,122,43,198,62
1500000US530330290012,530330290012,"Block Group 2, Census Tract 290.01, King County, Washington",370,85,41,50,10,16,31,48,329,83,82,64,247,62
1500000US530330290013,530330290013,"Block Group 3, Census Tract 290.01, King County, Washington",406,76,19,20,19,20,0,12,387,76,98,59,289,68
1500000US530330290014,530330290014,"Block Group 4, Census Tract 290.01, King County, Washington",769,95,40,35,40,35,0,12,729,92,203,65,526,98
1500000US530330290031,530330290031,"Block Group 1, Census Tract 290.03, King County, Washington",278,97,116,67,20,25,96,63,162,79,22,24,140,76
1500000US530330290032,530330290032,"Block Group 2, Census Tract 290.03, King County, Washington",531,136,129,103,13,23,116,102,402,128,110,66,292,139
1500000US530330290033,530330290033,"Block Group 3, Census Tract 290.03, King County, Washington",544,138,13,22,0,12,13,22,531,140,96,62,435,139
1500000US530330290034,530330290034,"Block Group 4, Census Tract 290.03, King County, Washington",329,118,64,62,39,52,25,33,265,119,35,35,230,116
1500000US530330290035,530330290035,"Block Group 5, Census Tract 290.03, King County, Washington",294,149,0,12,0,12,0,12,294,149,36,33,258,150
1500000US530330290041,530330290041,"Block Group 1, Census Tract 290.04, King County, Washington",629,91,134,54,40,30,94,48,495,80,106,46,389,83
1500000US530330290042,530330290042,"Block Group 2, Census Tract 290.04, King County, Washington",586,94,207,73,65,40,142,72,379,107,114,63,265,95
1500000US530330291011,530330291011,"Block Group 1, Census Tract 291.01, King County, Washington",412,75,75,59,33,46,42,36,337,63,34,24,303,61
1500000US530330291012,530330291012,"Block Group 2, Census Tract 291.01, King County, Washington",728,71,42,41,10,16,32,38,686,68,123,71,563,65
1500000US530330291021,530330291021,"Block Group 1, Census Tract 291.02, King County, Washington",422,85,62,52,42,53,20,26,360,82,55,38,305,91
1500000US530330291022,530330291022,"Block Group 2, Census Tract 291.02, King County, Washington",318,59,26,25,8,13,18,22,292,60,56,38,236,60
1500000US530330291023,530330291023,"Block Group 3, Census Tract 291.02, King County, Washington",658,94,92,70,7,12,85,70,566,88,101,49,465,90
1500000US530330292031,530330292031,"Block Group 1, Census Tract 292.03, King County, Washington",693,94,251,80,65,41,186,78,442,94,146,67,296,94
1500000US530330292032,530330292032,"Block Group 2, Census Tract 292.03, King County, Washington",402,91,111,64,46,38,65,48,291,78,92,55,199,67
1500000US530330292041,530330292041,"Block Group 1, Census Tract 292.04, King County, Washington",1021,196,198,97,132,85,66,52,823,219,266,138,557,175
1500000US530330292042,530330292042,"Block Group 2, Census Tract 292.04, King County, Washington",691,115,114,80,68,62,46,62,577,128,122,76,455,126
1500000US530330292043,530330292043,"Block Group 3, Census Tract 292.04, King County, Washington",238,72,21,34,21,34,0,12,217,73,59,49,158,70
1500000US530330292044,530330292044,"Block Group 4, Census Tract 292.04, King County, Washington",417,162,55,70,0,12,55,70,362,162,0,12,362,162
1500000US530330292051,530330292051,"Block Group 1, Census Tract 292.05, King County, Washington",1020,163,150,90,92,85,58,61,870,162,105,73,765,145
1500000US530330292052,530330292052,"Block Group 2, Census Tract 292.05, King County, Washington",437,148,195,124,127,101,68,70,242,132,17,28,225,131
1500000US530330292053,530330292053,"Block Group 3, Census Tract 292.05, King County, Washington",634,123,46,67,46,67,0,12,588,134,17,27,571,131
1500000US530330292061,530330292061,"Block Group 1, Census Tract 292.06, King County, Washington",218,77,65,55,0,12,65,55,153,61,27,22,126,60
1500000US530330292062,530330292062,"Block Group 2, Census Tract 292.06, King County, Washington",968,163,440,134,93,44,347,132,528,125,145,66,383,115
1500000US530330292063,530330292063,"Block Group 3, Census Tract 292.06, King County, Washington",534,110,71,50,13,23,58,45,463,108,49,48,414,108
1500000US530330293031,530330293031,"Block Group 1, Census Tract 293.03, King County, Washington",354,110,55,89,0,12,55,89,299,90,34,32,265,99
1500000US530330293032,530330293032,"Block Group 2, Census Tract 293.03, King County, Washington",251,74,68,76,0,12,68,76,183,65,31,27,152,70
1500000US530330293033,530330293033,"Block Group 3, Census Tract 293.03, King County, Washington",1252,160,70,54,35,38,35,38,1182,169,131,64,1051,170
1500000US530330293034,530330293034,"Block Group 4, Census Tract 293.03, King County, Washington",499,111,84,59,49,61,35,41,415,114,20,23,395,117
1500000US530330293035,530330293035,"Block Group 5, Census Tract 293.03, King County, Washington",618,143,21,26,8,14,13,22,597,141,82,77,515,122
1500000US530330293041,530330293041,"Block Group 1, Census Tract 293.04, King County, Washington",383,80,73,70,28,44,45,56,310,67,97,55,213,54
1500000US530330293042,530330293042,"Block Group 2, Census Tract 293.04, King County, Washington",375,57,0,12,0,12,0,12,375,57,41,31,334,59
1500000US530330293043,530330293043,"Block Group 3, Census Tract 293.04, King County, Washington",663,121,7,12,7,12,0,12,656,121,62,49,594,123
1500000US530330293044,530330293044,"Block Group 4, Census Tract 293.04, King County, Washington",364,61,7,12,0,12,7,12,357,62,37,26,320,67
1500000US530330293051,530330293051,"Block Group 1, Census Tract 293.05, King County, Washington",279,63,15,22,15,22,0,12,264,66,72,56,192,48
1500000US530330293052,530330293052,"Block Group 2, Census Tract 293.05, King County, Washington",481,87,239,96,150,82,89,80,242,72,51,37,191,64
1500000US530330293053,530330293053,"Block Group 3, Census Tract 293.05, King County, Washington",254,61,18,16,11,16,7,12,236,62,46,39,190,59
1500000US530330293054,530330293054,"Block Group 4, Census Tract 293.05, King County, Washington",251,55,18,27,0,12,18,27,233,54,56,34,177,59
1500000US530330293061,530330293061,"Block Group 1, Census Tract 293.06, King County, Washington",766,83,68,53,11,17,57,51,698,91,169,65,529,82
1500000US530330293062,530330293062,"Block Group 2, Census Tract 293.06, King County, Washington",421,59,29,27,20,21,9,15,392,59,68,41,324,70
1500000US530330293071,530330293071,"Block Group 1, Census Tract 293.07, King County, Washington",268,46,12,18,0,12,12,18,256,42,91,37,165,50
1500000US530330293072,530330293072,"Block Group 2, Census Tract 293.07, King County, Washington",559,67,38,28,10,15,28,26,521,78,55,33,466,84
1500000US530330293073,530330293073,"Block Group 3, Census Tract 293.07, King County, Washington",523,77,81,66,12,18,69,62,442,88,48,41,394,93
1500000US530330294031,530330294031,"Block Group 1, Census Tract 294.03, King County, Washington",636,91,44,32,17,20,27,24,592,97,121,43,471,102
1500000US530330294032,530330294032,"Block Group 2, Census Tract 294.03, King County, Washington",343,74,8,15,8,15,0,12,335,76,70,42,265,70
1500000US530330294033,530330294033,"Block Group 3, Census Tract 294.03, King County, Washington",820,116,207,96,93,76,114,67,613,94,96,40,517,98
1500000US530330294051,530330294051,"Block Group 1, Census Tract 294.05, King County, Washington",295,65,24,28,16,24,8,14,271,62,51,37,220,53
1500000US530330294052,530330294052,"Block Group 2, Census Tract 294.05, King County, Washington",468,86,15,22,0,12,15,22,453,89,85,57,368,85
1500000US530330294053,530330294053,"Block Group 3, Census Tract 294.05, King County, Washington",228,62,11,21,3,13,8,14,217,56,42,27,175,52
1500000US530330294054,530330294054,"Block Group 4, Census Tract 294.05, King County, Washington",305,73,59,58,0,12,59,58,246,74,2,7,244,73
1500000US530330294055,530330294055,"Block Group 5, Census Tract 294.05, King County, Washington",344,61,51,39,16,18,35,34,293,67,54,41,239,63
1500000US530330294061,530330294061,"Block Group 1, Census Tract 294.06, King County, Washington",621,105,63,40,24,27,39,39,558,96,86,70,472,91
1500000US530330294062,530330294062,"Block Group 2, Census Tract 294.06, King County, Washington",905,99,78,47,19,20,59,45,827,108,129,76,698,106
1500000US530330294071,530330294071,"Block Group 1, Census Tract 294.07, King County, Washington",418,82,100,56,56,38,44,43,318,82,69,43,249,74
1500000US530330294072,530330294072,"Block Group 2, Census Tract 294.07, King County, Washington",688,96,247,85,106,53,141,66,441,89,39,27,402,85
1500000US530330294073,530330294073,"Block Group 3, Census Tract 294.07, King County, Washington",345,82,33,35,0,12,33,35,312,86,106,45,206,83
1500000US530330294081,530330294081,"Block Group 1, Census Tract 294.08, King County, Washington",379,78,84,55,24,22,60,51,295,72,69,36,226,72
1500000US530330294082,530330294082,"Block Group 2, Census Tract 294.08, King County, Washington",376,75,17,20,10,15,7,12,359,76,39,28,320,80
1500000US530330294083,530330294083,"Block Group 3, Census Tract 294.08, King County, Washington",730,107,258,96,68,53,190,91,472,100,60,39,412,103
1500000US530330295021,530330295021,"Block Group 1, Census Tract 295.02, King County, Washington",712,93,108,74,43,45,65,56,604,96,155,76,449,100
1500000US530330295022,530330295022,"Block Group 2, Census Tract 295.02, King County, Washington",378,78,30,35,21,31,9,15,348,82,89,66,259,77
1500000US530330295023,530330295023,"Block Group 3, Census Tract 295.02, King County, Washington",360,94,9,16,0,12,9,16,351,98,25,30,326,99
1500000US530330295024,530330295024,"Block Group 4, Census Tract 295.02, King County, Washington",473,70,68,46,51,41,17,19,405,84,33,35,372,86
1500000US530330295031,530330295031,"Block Group 1, Census Tract 295.03, King County, Washington",308,88,63,48,53,48,10,18,245,88,10,17,235,93
1500000US530330295032,530330295032,"Block Group 2, Census Tract 295.03, King County, Washington",892,198,209,129,41,42,168,122,683,183,241,139,442,117
1500000US530330295033,530330295033,"Block Group 3, Census Tract 295.03, King County, Washington",612,163,385,149,117,74,268,129,227,96,45,45,182,94
1500000US530330295034,530330295034,"Block Group 4, Census Tract 295.03, King County, Washington",306,99,71,54,62,56,9,15,235,100,12,18,223,99
1500000US530330295035,530330295035,"Block Group 5, Census Tract 295.03, King County, Washington",733,150,228,119,100,74,128,95,505,161,84,80,421,147
1500000US530330295041,530330295041,"Block Group 1, Census Tract 295.04, King County, Washington",647,147,187,107,10,18,177,104,460,149,155,81,305,134
1500000US530330295042,530330295042,"Block Group 2, Census Tract 295.04, King County, Washington",553,124,145,63,124,60,21,25,408,111,42,45,366,113
1500000US530330295043,530330295043,"Block Group 3, Census Tract 295.04, King County, Washington",860,143,146,117,0,12,146,117,714,141,148,70,566,147
1500000US530330296011,530330296011,"Block Group 1, Census Tract 296.01, King County, Washington",480,113,127,85,31,39,96,75,353,103,95,69,258,99
1500000US530330296012,530330296012,"Block Group 2, Census Tract 296.01, King County, Washington",308,88,93,50,12,19,81,49,215,81,0,12,215,81
1500000US530330296013,530330296013,"Block Group 3, Census Tract 296.01, King County, Washington",449,103,202,107,131,102,71,58,247,85,57,53,190,78
1500000US530330296014,530330296014,"Block Group 4, Census Tract 296.01, King County, Washington",326,81,33,30,33,30,0,12,293,95,91,69,202,70
1500000US530330296015,530330296015,"Block Group 5, Census Tract 296.01, King County, Washington",314,105,32,38,0,12,32,38,282,103,6,12,276,103
1500000US530330296021,530330296021,"Block Group 1, Census Tract 296.02, King County, Washington",372,53,7,11,7,11,0,12,365,54,67,37,298,60
1500000US530330296022,530330296022,"Block Group 2, Census Tract 296.02, King County, Washington",429,65,0,12,0,12,0,12,429,65,36,28,393,68
1500000US530330296023,530330296023,"Block Group 3, Census Tract 296.02, King County, Washington",774,78,86,41,10,18,76,47,688,88,52,35,636,94
1500000US530330297001,530330297001,"Block Group 1, Census Tract 297, King County, Washington",565,111,30,33,30,33,0,12,535,113,192,75,343,119
1500000US530330297002,530330297002,"Block Group 2, Census Tract 297, King County, Washington",711,159,125,92,32,41,93,84,586,170,148,91,438,165
1500000US530330297003,530330297003,"Block Group 3, Census Tract 297, King County, Washington",724,163,262,114,115,74,147,88,462,140,68,50,394,145
1500000US530330297004,530330297004,"Block Group 4, Census Tract 297, King County, Washington",374,124,141,78,56,42,85,67,233,105,32,30,201,104
1500000US530330297005,530330297005,"Block Group 5, Census Tract 297, King County, Washington",468,136,234,147,50,45,184,148,234,105,119,91,115,63
1500000US530330298011,530330298011,"Block Group 1, Census Tract 298.01, King County, Washington",477,82,44,37,37,37,7,16,433,82,87,59,346,90
1500000US530330298012,530330298012,"Block Group 2, Census Tract 298.01, King County, Washington",594,133,10,16,10,16,0,12,584,130,76,67,508,126
1500000US530330298013,530330298013,"Block Group 3, Census Tract 298.01, King County, Washington",454,109,80,65,10,17,70,61,374,105,76,60,298,97
1500000US530330298014,530330298014,"Block Group 4, Census Tract 298.01, King County, Washington",514,119,69,47,0,12,69,47,445,127,102,79,343,102
1500000US530330298015,530330298015,"Block Group 5, Census Tract 298.01, King County, Washington",768,132,191,87,99,66,92,76,577,128,112,76,465,125
1500000US530330298021,530330298021,"Block Group 1, Census Tract 298.02, King County, Washington",465,86,80,84,60,78,20,30,385,85,116,66,269,89
1500000US530330298022,530330298022,"Block Group 2, Census Tract 298.02, King County, Washington",538,149,54,81,54,81,0,12,484,129,143,111,341,104
1500000US530330298023,530330298023,"Block Group 3, Census Tract 298.02, King County, Washington",838,158,47,46,19,29,28,34,791,157,59,39,732,155
1500000US530330298024,530330298024,"Block Group 4, Census Tract 298.02, King County, Washington",339,118,76,105,68,106,8,16,263,84,79,56,184,81
1500000US530330298025,530330298025,"Block Group 5, Census Tract 298.02, King County, Washington",418,91,12,20,12,20,0,12,406,86,16,25,390,92
1500000US530330298026,530330298026,"Block Group 6, Census Tract 298.02, King County, Washington",686,130,23,31,0,12,23,31,663,124,138,72,525,126
1500000US530330299011,530330299011,"Block Group 1, Census Tract 299.01, King County, Washington",677,99,16,23,0,12,16,23,661,101,127,52,534,115
1500000US530330299012,530330299012,"Block Group 2, Census Tract 299.01, King County, Washington",430,88,46,40,0,12,46,40,384,89,98,52,286,88
1500000US530330299013,530330299013,"Block Group 3, Census Tract 299.01, King County, Washington",604,73,217,97,80,55,137,95,387,81,51,35,336,75
1500000US530330299021,530330299021,"Block Group 1, Census Tract 299.02, King County, Washington",381,75,45,35,45,35,0,12,336,76,44,31,292,79
1500000US530330299022,530330299022,"Block Group 2, Census Tract 299.02, King County, Washington",422,72,24,21,16,19,8,10,398,73,71,64,327,59
1500000US530330299023,530330299023,"Block Group 3, Census Tract 299.02, King County, Washington",682,74,0,12,0,12,0,12,682,74,90,46,592,80
1500000US530330300031,530330300031,"Block Group 1, Census Tract 300.03, King County, Washington",465,140,0,12,0,12,0,12,465,140,101,73,364,139
1500000US530330300032,530330300032,"Block Group 2, Census Tract 300.03, King County, Washington",747,156,181,110,80,78,101,84,566,146,150,97,416,126
1500000US530330300033,530330300033,"Block Group 3, Census Tract 300.03, King County, Washington",217,76,33,38,33,38,0,12,184,71,22,25,162,71
1500000US530330300034,530330300034,"Block Group 4, Census Tract 300.03, King County, Washington",362,94,13,20,13,20,0,12,349,97,17,27,332,98
1500000US530330300035,530330300035,"Block Group 5, Census Tract 300.03, King County, Washington",345,111,39,61,39,61,0,12,306,121,55,44,251,115
1500000US530330300041,530330300041,"Block Group 1, Census Tract 300.04, King County, Washington",395,121,155,112,75,90,80,69,240,86,27,40,213,82
1500000US530330300042,530330300042,"Block Group 2, Census Tract 300.04, King County, Washington",840,213,88,61,61,52,27,34,752,217,63,52,689,219
1500000US530330300043,530330300043,"Block Group 3, Census Tract 300.04, King County, Washington",366,123,52,50,16,25,36,37,314,119,53,55,261,106
1500000US530330300044,530330300044,"Block Group 4, Census Tract 300.04, King County, Washington",341,88,5,13,0,12,5,13,336,91,67,53,269,88
1500000US530330300045,530330300045,"Block Group 5, Census Tract 300.04, King County, Washington",646,175,375,186,159,151,216,157,271,135,42,70,229,135
1500000US530330300046,530330300046,"Block Group 6, Census Tract 300.04, King County, Washington",374,135,144,102,31,34,113,96,230,93,32,37,198,89
1500000US530330300051,530330300051,"Block Group 1, Census Tract 300.05, King County, Washington",607,116,110,76,42,36,68,66,497,109,153,77,344,118
1500000US530330300052,530330300052,"Block Group 2, Census Tract 300.05, King County, Washington",528,94,79,55,12,19,67,52,449,92,86,50,363,87
1500000US530330300053,530330300053,"Block Group 3, Census Tract 300.05, King County, Washington",633,121,281,98,107,59,174,85,352,110,40,35,312,108
1500000US530330300061,530330300061,"Block Group 1, Census Tract 300.06, King County, Washington",668,107,228,105,111,73,117,83,440,74,113,60,327,85
1500000US530330300062,530330300062,"Block Group 2, Census Tract 300.06, King County, Washington",999,117,341,118,163,96,178,83,658,129,331,93,327,110
1500000US530330301001,530330301001,"Block Group 1, Census Tract 301, King County, Washington",305,58,44,51,33,50,11,21,261,58,135,63,126,57
1500000US530330301002,530330301002,"Block Group 2, Census Tract 301, King County, Washington",359,88,18,28,18,28,0,12,341,85,74,68,267,79
1500000US530330301003,530330301003,"Block Group 3, Census Tract 301, King County, Washington",608,112,11,17,11,17,0,12,597,112,90,56,507,118
1500000US530330301004,530330301004,"Block Group 4, Census Tract 301, King County, Washington",214,91,0,12,0,12,0,12,214,91,70,63,144,73
1500000US530330301005,530330301005,"Block Group 5, Census Tract 301, King County, Washington",284,113,67,57,0,12,67,57,217,108,54,47,163,112
1500000US530330301006,530330301006,"Block Group 6, Census Tract 301, King County, Washington",494,107,0,12,0,12,0,12,494,107,189,111,305,97
1500000US530330301007,530330301007,"Block Group 7, Census Tract 301, King County, Washington",453,142,40,52,40,52,0,12,413,154,154,115,259,92
1500000US530330302011,530330302011,"Block Group 1, Census Tract 302.01, King County, Washington",275,90,50,55,0,12,50,55,225,75,64,35,161,75
1500000US530330302012,530330302012,"Block Group 2, Census Tract 302.01, King County, Washington",528,122,167,104,57,63,110,87,361,100,61,62,300,98
1500000US530330302013,530330302013,"Block Group 3, Census Tract 302.01, King County, Washington",504,87,11,17,0,12,11,17,493,89,91,75,402,97
1500000US530330302014,530330302014,"Block Group 4, Census Tract 302.01, King County, Washington",702,103,92,56,23,28,69,54,610,106,155,68,455,107
1500000US530330302021,530330302021,"Block Group 1, Census Tract 302.02, King County, Washington",296,96,0,12,0,12,0,12,296,96,58,60,238,92
1500000US530330302022,530330302022,"Block Group 2, Census Tract 302.02, King County, Washington",554,125,56,69,56,69,0,12,498,125,141,70,357,130
1500000US530330302023,530330302023,"Block Group 3, Census Tract 302.02, King County, Washington",365,120,119,76,0,12,119,76,246,101,25,46,221,90
1500000US530330302024,530330302024,"Block Group 4, Census Tract 302.02, King County, Washington",523,143,128,96,103,92,25,38,395,127,88,79,307,109
1500000US530330302025,530330302025,"Block Group 5, Census Tract 302.02, King County, Washington",601,135,81,74,33,40,48,59,520,136,161,86,359,128
1500000US530330303041,530330303041,"Block Group 1, Census Tract 303.04, King County, Washington",572,83,92,57,71,53,21,24,480,92,96,46,384,88
1500000US530330303042,530330303042,"Block Group 2, Census Tract 303.04, King County, Washington",435,71,57,40,37,35,20,21,378,74,84,46,294,76
1500000US530330303051,530330303051,"Block Group 1, Census Tract 303.05, King County, Washington",838,135,168,109,57,65,111,101,670,130,104,59,566,146
1500000US530330303052,530330303052,"Block Group 2, Census Tract 303.05, King County, Washington",657,133,43,42,26,33,17,24,614,137,129,69,485,144
1500000US530330303053,530330303053,"Block Group 3, Census Tract 303.05, King County, Washington",587,94,67,55,0,12,67,55,520,93,159,65,361,100
1500000US530330303061,530330303061,"Block Group 1, Census Tract 303.06, King County, Washington",493,87,94,49,34,30,60,44,399,86,45,39,354,87
1500000US530330303062,530330303062,"Block Group 2, Census Tract 303.06, King County, Washington",400,97,8,14,0,12,8,14,392,96,96,61,296,97
1500000US530330303063,530330303063,"Block Group 3, Census Tract 303.06, King County, Washington",774,102,82,49,56,38,26,30,692,115,190,76,502,132
1500000US530330303064,530330303064,"Block Group 4, Census Tract 303.06, King County, Washington",384,87,16,19,8,14,8,13,368,86,87,58,281,91
1500000US530330303081,530330303081,"Block Group 1, Census Tract 303.08, King County, Washington",309,73,8,13,0,12,8,13,301,73,52,48,249,75
1500000US530330303082,530330303082,"Block Group 2, Census Tract 303.08, King County, Washington",684,113,75,64,48,57,27,33,609,116,73,60,536,111
1500000US530330303083,530330303083,"Block Group 3, Census Tract 303.08, King County, Washington",490,103,51,52,51,52,0,12,439,95,48,41,391,103
1500000US530330303084,530330303084,"Block Group 4, Census Tract 303.08, King County, Washington",773,145,184,114,13,21,171,112,589,166,119,70,470,158
1500000US530330303091,530330303091,"Block Group 1, Census Tract 303.09, King County, Washington",396,94,27,42,0,12,27,42,369,90,48,54,321,98
1500000US530330303092,530330303092,"Block Group 2, Census Tract 303.09, King County, Washington",561,119,126,95,65,84,61,56,435,113,41,46,394,105
1500000US530330303093,530330303093,"Block Group 3, Census Tract 303.09, King County, Washington",585,133,119,86,38,45,81,77,466,146,55,83,411,126
1500000US530330303094,530330303094,"Block Group 4, Census Tract 303.09, King County, Washington",813,173,150,96,115,90,35,34,663,168,99,65,564,177
1500000US530330303101,530330303101,"Block Group 1, Census Tract 303.10, King County, Washington",339,88,46,34,8,14,38,31,293,89,10,17,283,88
1500000US530330303102,530330303102,"Block Group 2, Census Tract 303.10, King County, Washington",327,72,43,36,14,22,29,28,284,79,46,33,238,76
1500000US530330303103,530330303103,"Block Group 3, Census Tract 303.10, King County, Washington",415,78,13,20,13,20,0,12,402,77,55,39,347,82
1500000US530330303104,530330303104,"Block Group 4, Census Tract 303.10, King County, Washington",878,123,80,72,0,12,80,72,798,127,267,102,531,124
1500000US530330303111,530330303111,"Block Group 1, Census Tract 303.11, King County, Washington",384,109,25,29,0,12,25,29,359,103,33,28,326,107
1500000US530330303112,530330303112,"Block Group 2, Census Tract 303.11, King County, Washington",585,114,153,108,78,73,75,75,432,121,67,67,365,109
1500000US530330303113,530330303113,"Block Group 3, Census Tract 303.11, King County, Washington",391,69,56,37,28,30,28,28,335,66,108,53,227,67
1500000US530330303114,530330303114,"Block Group 4, Census Tract 303.11, King County, Washington",335,88,89,83,0,12,89,83,246,77,32,26,214,80
1500000US530330303121,530330303121,"Block Group 1, Census Tract 303.12, King County, Washington",627,121,155,84,103,73,52,46,472,108,153,88,319,95
1500000US530330303122,530330303122,"Block Group 2, Census Tract 303.12, King County, Washington",473,94,40,38,40,38,0,12,433,92,92,64,341,99
1500000US530330303123,530330303123,"Block Group 3, Census Tract 303.12, King County, Washington",384,70,80,43,25,21,55,41,304,73,41,36,263,71
1500000US530330303124,530330303124,"Block Group 4, Census Tract 303.12, King County, Washington",292,77,6,14,4,11,2,9,286,78,53,45,233,74
1500000US530330303131,530330303131,"Block Group 1, Census Tract 303.13, King County, Washington",771,126,127,77,42,36,85,66,644,122,115,52,529,126
1500000US530330303132,530330303132,"Block Group 2, Census Tract 303.13, King County, Washington",920,139,240,125,142,86,98,92,680,148,107,84,573,147
1500000US530330303141,530330303141,"Block Group 1, Census Tract 303.14, King County, Washington",781,120,286,106,126,72,160,91,495,127,146,87,349,112
1500000US530330303142,530330303142,"Block Group 2, Census Tract 303.14, King County, Washington",402,99,56,67,14,21,42,60,346,96,110,46,236,97
1500000US530330303143,530330303143,"Block Group 3, Census Tract 303.14, King County, Washington",699,119,158,80,52,48,106,63,541,114,276,108,265,93
1500000US530330304011,530330304011,"Block Group 1, Census Tract 304.01, King County, Washington",870,155,112,74,10,17,102,71,758,148,75,61,683,156
1500000US530330304012,530330304012,"Block Group 2, Census Tract 304.01, King County, Washington",537,109,41,32,6,13,35,30,496,107,148,67,348,110
1500000US530330304013,530330304013,"Block Group 3, Census Tract 304.01, King County, Washington",596,116,74,53,19,28,55,52,522,133,139,95,383,137
1500000US530330304014,530330304014,"Block Group 4, Census Tract 304.01, King County, Washington",384,132,22,29,0,12,22,29,362,135,60,58,302,126
1500000US530330304015,530330304015,"Block Group 5, Census Tract 304.01, King County, Washington",674,157,39,37,16,29,23,36,635,154,70,54,565,162
1500000US530330304031,530330304031,"Block Group 1, Census Tract 304.03, King County, Washington",650,91,77,69,9,12,68,68,573,78,159,71,414,82
1500000US530330304032,530330304032,"Block Group 2, Census Tract 304.03, King County, Washington",337,59,22,22,6,10,16,18,315,61,32,24,283,64
1500000US530330304033,530330304033,"Block Group 3, Census Tract 304.03, King County, Washington",693,86,40,42,31,40,9,15,653,89,90,40,563,98
1500000US530330304041,530330304041,"Block Group 1, Census Tract 304.04, King County, Washington",686,98,35,38,0,12,35,38,651,99,117,40,534,99
1500000US530330304042,530330304042,"Block Group 2, Census Tract 304.04, King County, Washington",487,84,46,34,32,27,14,22,441,83,42,33,399,84
1500000US530330304043,530330304043,"Block Group 3, Census Tract 304.04, King County, Washington",429,85,11,16,11,16,0,12,418,86,141,88,277,75
1500000US530330305011,530330305011,"Block Group 1, Census Tract 305.01, King County, Washington",369,66,137,63,76,57,61,39,232,49,61,34,171,56
1500000US530330305012,530330305012,"Block Group 2, Census Tract 305.01, King County, Washington",600,69,195,61,91,41,104,54,405,75,121,48,284,78
1500000US530330305031,530330305031,"Block Group 1, Census Tract 305.03, King County, Washington",890,123,238,114,135,79,103,82,652,122,189,64,463,130
1500000US530330305032,530330305032,"Block Group 2, Census Tract 305.03, King County, Washington",1125,134,127,84,29,27,98,81,998,134,276,97,722,121
1500000US530330305041,530330305041,"Block Group 1, Census Tract 305.04, King County, Washington",427,118,44,41,15,17,29,36,383,119,57,54,326,132
1500000US530330305042,530330305042,"Block Group 2, Census Tract 305.04, King County, Washington",418,80,75,49,28,28,47,48,343,81,104,50,239,83
1500000US530330305043,530330305043,"Block Group 3, Census Tract 305.04, King County, Washington",354,86,125,68,81,61,44,51,229,77,53,35,176,73
1500000US530330305044,530330305044,"Block Group 4, Census Tract 305.04, King County, Washington",733,103,153,82,65,52,88,77,580,97,174,58,406,103
1500000US530330306001,530330306001,"Block Group 1, Census Tract 306, King County, Washington",546,120,127,115,52,60,75,92,419,119,46,43,373,135
1500000US530330306002,530330306002,"Block Group 2, Census Tract 306, King County, Washington",617,106,116,84,14,23,102,81,501,96,60,45,441,104
1500000US530330306003,530330306003,"Block Group 3, Census Tract 306, King County, Washington",459,112,128,73,82,58,46,40,331,122,71,49,260,124
1500000US530330306004,530330306004,"Block Group 4, Census Tract 306, King County, Washington",592,133,186,96,97,64,89,79,406,130,136,82,270,111
1500000US530330307001,530330307001,"Block Group 1, Census Tract 307, King County, Washington",555,85,213,82,121,79,92,52,342,87,46,34,296,91
1500000US530330307002,530330307002,"Block Group 2, Census Tract 307, King County, Washington",524,93,115,49,60,43,55,36,409,99,111,53,298,93
1500000US530330307003,530330307003,"Block Group 3, Census Tract 307, King County, Washington",387,101,62,44,21,21,41,35,325,96,76,48,249,87
1500000US530330308011,530330308011,"Block Group 1, Census Tract 308.01, King County, Washington",705,148,218,127,84,70,134,112,487,123,131,76,356,136
1500000US530330308012,530330308012,"Block Group 2, Census Tract 308.01, King County, Washington",770,147,437,137,209,105,228,115,333,130,71,69,262,113
1500000US530330308013,530330308013,"Block Group 3, Census Tract 308.01, King County, Washington",1005,155,275,129,85,61,190,122,730,160,181,90,549,142
1500000US530330308021,530330308021,"Block Group 1, Census Tract 308.02, King County, Washington",495,98,138,71,108,70,30,33,357,103,36,30,321,100
1500000US530330308022,530330308022,"Block Group 2, Census Tract 308.02, King County, Washington",520,87,67,45,11,17,56,41,453,97,170,85,283,77
1500000US530330308023,530330308023,"Block Group 3, Census Tract 308.02, King County, Washington",415,81,107,70,69,65,38,38,308,93,51,40,257,89
1500000US530330309011,530330309011,"Block Group 1, Census Tract 309.01, King County, Washington",540,80,86,40,54,33,32,28,454,88,135,62,319,71
1500000US530330309012,530330309012,"Block Group 2, Census Tract 309.01, King County, Washington",539,82,119,57,66,45,53,37,420,89,118,54,302,85
1500000US530330309021,530330309021,"Block Group 1, Census Tract 309.02, King County, Washington",832,130,224,82,110,67,114,66,608,147,199,85,409,123
1500000US530330309022,530330309022,"Block Group 2, Census Tract 309.02, King County, Washington",438,86,75,63,23,25,52,56,363,86,62,37,301,86
1500000US530330309023,530330309023,"Block Group 3, Census Tract 309.02, King County, Washington",677,122,155,62,62,43,93,52,522,121,28,25,494,120
1500000US530330310001,530330310001,"Block Group 1, Census Tract 310, King County, Washington",711,74,29,34,13,19,16,27,682,74,137,57,545,81
1500000US530330310002,530330310002,"Block Group 2, Census Tract 310, King County, Washington",553,87,0,12,0,12,0,12,553,87,31,27,522,90
1500000US530330311001,530330311001,"Block Group 1, Census Tract 311, King County, Washington",409,123,89,60,15,21,74,56,320,117,98,76,222,109
1500000US530330311002,530330311002,"Block Group 2, Census Tract 311, King County, Washington",591,95,130,92,69,67,61,66,461,90,152,51,309,79
1500000US530330311003,530330311003,"Block Group 3, Census Tract 311, King County, Washington",682,98,107,38,52,28,55,22,575,92,141,38,434,78
1500000US530330311004,530330311004,"Block Group 4, Census Tract 311, King County, Washington",558,129,155,86,72,57,83,66,403,121,166,88,237,109
1500000US530330311005,530330311005,"Block Group 5, Census Tract 311, King County, Washington",456,130,178,76,76,61,102,55,278,112,115,78,163,73
1500000US530330312021,530330312021,"Block Group 1, Census Tract 312.02, King County, Washington",500,137,102,97,3,8,99,97,398,129,51,49,347,134
1500000US530330312022,530330312022,"Block Group 2, Census Tract 312.02, King County, Washington",258,81,43,36,34,33,9,13,215,83,14,17,201,85
1500000US530330312023,530330312023,"Block Group 3, Census Tract 312.02, King County, Washington",451,95,14,23,0,12,14,23,437,95,72,59,365,95
1500000US530330312024,530330312024,"Block Group 4, Census Tract 312.02, King County, Washington",501,91,22,33,22,33,0,12,479,92,124,89,355,90
1500000US530330312025,530330312025,"Block Group 5, Census Tract 312.02, King County, Washington",595,116,152,44,60,30,92,36,443,119,116,53,327,110
1500000US530330312041,530330312041,"Block Group 1, Census Tract 312.04, King County, Washington",459,139,0,12,0,12,0,12,459,139,109,68,350,131
1500000US530330312042,530330312042,"Block Group 2, Census Tract 312.04, King County, Washington",502,119,0,12,0,12,0,12,502,119,123,81,379,111
1500000US530330312043,530330312043,"Block Group 3, Census Tract 312.04, King County, Washington",472,105,21,26,0,12,21,26,451,108,116,78,335,120
1500000US530330312044,530330312044,"Block Group 4, Census Tract 312.04, King County, Washington",324,98,0,12,0,12,0,12,324,98,103,58,221,107
1500000US530330312045,530330312045,"Block Group 5, Census Tract 312.04, King County, Washington",540,128,0,12,0,12,0,12,540,128,126,104,414,132
1500000US530330312051,530330312051,"Block Group 1, Census Tract 312.05, King County, Washington",888,153,203,124,64,69,139,115,685,136,26,33,659,136
1500000US530330312052,530330312052,"Block Group 2, Census Tract 312.05, King County, Washington",885,154,234,119,177,129,57,51,651,124,128,68,523,128
1500000US530330312053,530330312053,"Block Group 3, Census Tract 312.05, King County, Washington",569,127,90,80,65,70,25,39,479,113,64,58,415,120
1500000US530330312061,530330312061,"Block Group 1, Census Tract 312.06, King County, Washington",482,96,60,60,8,13,52,58,422,104,72,44,350,98
1500000US530330312062,530330312062,"Block Group 2, Census Tract 312.06, King County, Washington",636,96,26,24,8,14,18,21,610,94,214,68,396,93
1500000US530330312063,530330312063,"Block Group 3, Census Tract 312.06, King County, Washington",661,105,167,96,59,57,108,82,494,102,25,24,469,103
1500000US530330313011,530330313011,"Block Group 1, Census Tract 313.01, King County, Washington",527,71,34,33,0,12,34,33,493,68,94,50,399,75
1500000US530330313012,530330313012,"Block Group 2, Census Tract 313.01, King County, Washington",500,74,20,18,0,12,20,18,480,76,71,37,409,84
1500000US530330313021,530330313021,"Block Group 1, Census Tract 313.02, King County, Washington",341,61,8,12,0,12,8,12,333,61,55,44,278,57
1500000US530330313022,530330313022,"Block Group 2, Census Tract 313.02, King County, Washington",384,69,24,29,5,9,19,28,360,69,41,32,319,73
1500000US530330313023,530330313023,"Block Group 3, Census Tract 313.02, King County, Washington",448,52,27,22,27,22,0,12,421,57,130,46,291,56
1500000US530330313024,530330313024,"Block Group 4, Census Tract 313.02, King County, Washington",437,78,98,51,33,41,65,41,339,75,50,45,289,68
1500000US530330314001,530330314001,"Block Group 1, Census Tract 314, King County, Washington",305,107,91,75,91,75,0,12,214,87,23,26,191,89
1500000US530330314002,530330314002,"Block Group 2, Census Tract 314, King County, Washington",615,105,68,51,14,23,54,44,547,113,151,97,396,102
1500000US530330314003,530330314003,"Block Group 3, Census Tract 314, King County, Washington",593,116,57,39,45,33,12,20,536,119,116,56,420,120
1500000US530330314004,530330314004,"Block Group 4, Census Tract 314, King County, Washington",365,97,84,79,56,73,28,31,281,86,63,67,218,86
1500000US530330314005,530330314005,"Block Group 5, Census Tract 314, King County, Washington",398,91,139,88,41,39,98,97,259,73,49,35,210,67
1500000US530330315011,530330315011,"Block Group 1, Census Tract 315.01, King County, Washington",455,89,78,72,78,72,0,12,377,80,111,53,266,80
1500000US530330315012,530330315012,"Block Group 2, Census Tract 315.01, King County, Washington",601,91,34,30,15,21,19,21,567,95,132,66,435,103
1500000US530330315013,530330315013,"Block Group 3, Census Tract 315.01, King County, Washington",503,87,52,43,31,35,21,23,451,88,182,93,269,89
1500000US530330315021,530330315021,"Block Group 1, Census Tract 315.02, King County, Washington",553,94,58,60,18,22,40,57,495,88,31,29,464,91
1500000US530330315022,530330315022,"Block Group 2, Census Tract 315.02, King County, Washington",526,84,38,42,22,35,16,22,488,79,116,58,372,90
1500000US530330315023,530330315023,"Block Group 3, Census Tract 315.02, King County, Washington",685,81,78,57,72,57,6,9,607,88,105,49,502,95
1500000US530330316011,530330316011,"Block Group 1, Census Tract 316.01, King County, Washington",754,103,26,37,0,12,26,37,728,102,88,50,640,105
1500000US530330316012,530330316012,"Block Group 2, Census Tract 316.01, King County, Washington",720,94,48,40,19,27,29,32,672,100,156,79,516,111
1500000US530330316013,530330316013,"Block Group 3, Census Tract 316.01, King County, Washington",509,82,56,42,36,37,20,21,453,74,100,49,353,74
1500000US530330316031,530330316031,"Block Group 1, Census Tract 316.03, King County, Washington",600,96,84,83,12,19,72,80,516,110,77,68,439,95
1500000US530330316032,530330316032,"Block Group 2, Census Tract 316.03, King County, Washington",397,81,0,12,0,12,0,12,397,81,85,61,312,80
1500000US530330316033,530330316033,"Block Group 3, Census Tract 316.03, King County, Washington",499,101,11,18,0,12,11,18,488,100,32,27,456,101
1500000US530330316034,530330316034,"Block Group 4, Census Tract 316.03, King County, Washington",564,92,0,12,0,12,0,12,564,92,72,45,492,97
1500000US530330316041,530330316041,"Block Group 1, Census Tract 316.04, King County, Washington",857,99,30,23,0,12,30,23,827,100,135,63,692,118
1500000US530330316042,530330316042,"Block Group 2, Census Tract 316.04, King County, Washington",321,69,18,28,0,12,18,28,303,72,45,36,258,74
1500000US530330316043,530330316043,"Block Group 3, Census Tract 316.04, King County, Washington",435,87,14,22,14,22,0,12,421,85,66,40,355,92
1500000US530330316051,530330316051,"Block Group 1, Census Tract 316.05, King County, Washington",438,75,20,30,20,30,0,12,418,77,81,56,337,87
1500000US530330316052,530330316052,"Block Group 2, Census Tract 316.05, King County, Washington",471,93,57,54,20,30,37,43,414,94,39,35,375,95
1500000US530330316053,530330316053,"Block Group 3, Census Tract 316.05, King County, Washington",405,82,38,37,21,30,17,25,367,85,76,63,291,90
1500000US530330317031,530330317031,"Block Group 1, Census Tract 317.03, King County, Washington",435,83,26,33,15,25,11,20,409,90,66,54,343,100
1500000US530330317032,530330317032,"Block Group 2, Census Tract 317.03, King County, Washington",510,100,18,29,18,29,0,12,492,105,85,62,407,99
1500000US530330317033,530330317033,"Block Group 3, Census Tract 317.03, King County, Washington",522,93,124,90,45,51,79,75,398,91,101,62,297,92
1500000US530330317034,530330317034,"Block Group 4, Census Tract 317.03, King County, Washington",559,92,58,41,40,29,18,28,501,83,98,55,403,77
1500000US530330317035,530330317035,"Block Group 5, Census Tract 317.03, King County, Washington",532,91,0,12,0,12,0,12,532,91,59,43,473,104
1500000US530330317041,530330317041,"Block Group 1, Census Tract 317.04, King County, Washington",389,71,58,43,19,30,39,36,331,64,40,30,291,68
1500000US530330317042,530330317042,"Block Group 2, Census Tract 317.04, King County, Washington",486,75,88,40,5,10,83,43,398,73,80,45,318,76
1500000US530330317043,530330317043,"Block Group 3, Census Tract 317.04, King County, Washington",713,102,94,52,44,40,50,31,619,110,83,43,536,109
1500000US530330317051,530330317051,"Block Group 1, Census Tract 317.05, King County, Washington",401,109,10,16,0,12,10,16,391,109,43,39,348,107
1500000US530330317052,530330317052,"Block Group 2, Census Tract 317.05, King County, Washington",380,92,17,27,0,12,17,27,363,91,76,46,287,90
1500000US530330317053,530330317053,"Block Group 3, Census Tract 317.05, King County, Washington",493,97,16,21,16,21,0,12,477,98,31,38,446,99
1500000US530330317061,530330317061,"Block Group 1, Census Tract 317.06, King County, Washington",420,132,19,30,19,30,0,12,401,135,166,145,235,98
1500000US530330317062,530330317062,"Block Group 2, Census Tract 317.06, King County, Washington",610,136,102,70,25,28,77,68,508,130,162,83,346,120
1500000US530330317063,530330317063,"Block Group 3, Census Tract 317.06, King County, Washington",596,116,106,100,17,27,89,95,490,119,132,84,358,109
1500000US530330317064,530330317064,"Block Group 4, Census Tract 317.06, King County, Washington",598,123,91,84,25,38,66,80,507,104,47,49,460,95
1500000US530330318001,530330318001,"Block Group 1, Census Tract 318, King County, Washington",729,90,12,19,0,12,12,19,717,91,125,61,592,93
1500000US530330318002,530330318002,"Block Group 2, Census Tract 318, King County, Washington",550,91,9,13,9,13,0,12,541,94,76,38,465,97
1500000US530330318003,530330318003,"Block Group 3, Census Tract 318, King County, Washington",507,78,8,14,8,14,0,12,499,79,120,50,379,94
1500000US530330319031,530330319031,"Block Group 1, Census Tract 319.03, King County, Washington",561,108,0,12,0,12,0,12,561,108,196,97,365,120
1500000US530330319032,530330319032,"Block Group 2, Census Tract 319.03, King County, Washington",595,103,93,95,93,95,0,12,502,87,128,46,374,93
1500000US530330319033,530330319033,"Block Group 3, Census Tract 319.03, King County, Washington",414,71,6,14,0,12,6,14,408,71,82,57,326,95
1500000US530330319034,530330319034,"Block Group 4, Census Tract 319.03, King County, Washington",395,78,16,26,0,12,16,26,379,81,152,65,227,74
1500000US530330319035,530330319035,"Block Group 5, Census Tract 319.03, King County, Washington",545,127,179,134,74,93,105,98,366,108,67,54,299,109
1500000US530330319041,530330319041,"Block Group 1, Census Tract 319.04, King County, Washington",615,61,24,29,0,12,24,29,591,65,63,36,528,67
1500000US530330319042,530330319042,"Block Group 2, Census Tract 319.04, King County, Washington",266,55,0,12,0,12,0,12,266,55,18,20,248,59
1500000US530330319043,530330319043,"Block Group 3, Census Tract 319.04, King County, Washington",445,83,34,47,0,12,34,47,411,88,124,52,287,86
1500000US530330319061,530330319061,"Block Group 1, Census Tract 319.06, King County, Washington",549,97,33,40,33,40,0,12,516,99,47,35,469,101
1500000US530330319062,530330319062,"Block Group 2, Census Tract 319.06, King County, Washington",841,105,10,17,10,17,0,12,831,105,101,53,730,117
1500000US530330319071,530330319071,"Block Group 1, Census Tract 319.07, King County, Washington",359,90,0,12,0,12,0,12,359,90,79,64,280,81
1500000US530330319072,530330319072,"Block Group 2, Census Tract 319.07, King County, Washington",328,69,0,12,0,12,0,12,328,69,102,58,226,74
1500000US530330319073,530330319073,"Block Group 3, Census Tract 319.07, King County, Washington",999,170,52,59,12,19,40,56,947,149,76,74,871,160
1500000US530330319074,530330319074,"Block Group 4, Census Tract 319.07, King County, Washington",809,132,38,41,38,41,0,12,771,131,24,41,747,133
1500000US530330319075,530330319075,"Block Group 5, Census Tract 319.07, King County, Washington",403,110,15,26,0,12,15,26,388,111,39,53,349,99
1500000US530330319081,530330319081,"Block Group 1, Census Tract 319.08, King County, Washington",842,93,106,66,27,32,79,60,736,112,148,80,588,121
1500000US530330319082,530330319082,"Block Group 2, Census Tract 319.08, King County, Washington",700,101,169,85,105,60,64,62,531,116,126,74,405,114
1500000US530330319083,530330319083,"Block Group 3, Census Tract 319.08, King County, Washington",526,82,61,38,41,32,20,22,465,81,133,73,332,83
1500000US530330319091,530330319091,"Block Group 1, Census Tract 319.09, King County, Washington",786,86,156,77,72,50,84,64,630,101,77,48,553,94
1500000US530330319092,530330319092,"Block Group 2, Census Tract 319.09, King County, Washington",459,73,0,12,0,12,0,12,459,73,84,58,375,71
1500000US530330320021,530330320021,"Block Group 1, Census Tract 320.02, King County, Washington",657,85,62,45,47,39,15,21,595,99,135,59,460,107
1500000US530330320022,530330320022,"Block Group 2, Census Tract 320.02, King County, Washington",587,87,11,14,7,11,4,8,576,90,121,80,455,81
1500000US530330320031,530330320031,"Block Group 1, Census Tract 320.03, King County, Washington",580,79,21,27,0,12,21,27,559,80,118,57,441,79
1500000US530330320032,530330320032,"Block Group 2, Census Tract 320.03, King County, Washington",525,114,0,12,0,12,0,12,525,114,78,50,447,121
1500000US530330320033,530330320033,"Block Group 3, Census Tract 320.03, King County, Washington",345,86,34,38,14,22,20,31,311,81,72,50,239,74
1500000US530330320034,530330320034,"Block Group 4, Census Tract 320.03, King County, Washington",533,116,23,36,0,12,23,36,510,114,111,62,399,115
1500000US530330320051,530330320051,"Block Group 1, Census Tract 320.05, King County, Washington",374,137,0,12,0,12,0,12,374,137,22,30,352,134
1500000US530330320052,530330320052,"Block Group 2, Census Tract 320.05, King County, Washington",377,103,36,39,18,29,18,26,341,109,59,45,282,110
1500000US530330320053,530330320053,"Block Group 3, Census Tract 320.05, King County, Washington",229,94,47,50,47,50,0,12,182,97,0,12,182,97
1500000US530330320054,530330320054,"Block Group 4, Census Tract 320.05, King County, Washington",407,101,53,51,13,21,40,45,354,104,70,51,284,96
1500000US530330320055,530330320055,"Block Group 5, Census Tract 320.05, King County, Washington",632,117,95,90,15,24,80,87,537,127,101,92,436,132
1500000US530330320056,530330320056,"Block Group 6, Census Tract 320.05, King County, Washington",240,66,7,14,0,12,7,14,233,67,35,43,198,66
1500000US530330320061,530330320061,"Block Group 1, Census Tract 320.06, King County, Washington",446,70,30,27,30,27,0,12,416,71,61,40,355,77
1500000US530330320062,530330320062,"Block Group 2, Census Tract 320.06, King County, Washington",752,96,33,26,10,15,23,21,719,96,121,44,598,103
1500000US530330320063,530330320063,"Block Group 3, Census Tract 320.06, King County, Washington",521,61,51,43,0,12,51,43,470,71,32,23,438,73
1500000US530330320071,530330320071,"Block Group 1, Census Tract 320.07, King County, Washington",489,86,0,12,0,12,0,12,489,86,110,62,379,102
1500000US530330320072,530330320072,"Block Group 2, Census Tract 320.07, King County, Washington",454,86,0,12,0,12,0,12,454,86,40,37,414,86
1500000US530330320073,530330320073,"Block Group 3, Census Tract 320.07, King County, Washington",433,85,64,52,10,15,54,50,369,92,108,70,261,81
1500000US530330320081,530330320081,"Block Group 1, Census Tract 320.08, King County, Washington",501,75,0,12,0,12,0,12,501,75,62,40,439,75
1500000US530330320082,530330320082,"Block Group 2, Census Tract 320.08, King County, Washington",527,87,33,30,23,26,10,15,494,89,87,52,407,90
1500000US530330320083,530330320083,"Block Group 3, Census Tract 320.08, King County, Washington",377,76,10,15,10,15,0,12,367,78,54,36,313,80
1500000US530330320101,530330320101,"Block Group 1, Census Tract 320.10, King County, Washington",639,113,64,65,0,12,64,65,575,118,191,84,384,107
1500000US530330320102,530330320102,"Block Group 2, Census Tract 320.10, King County, Washington",393,78,0,12,0,12,0,12,393,78,25,28,368,79
1500000US530330320103,530330320103,"Block Group 3, Census Tract 320.10, King County, Washington",371,82,12,21,0,12,12,21,359,84,45,41,314,81
1500000US530330320104,530330320104,"Block Group 4, Census Tract 320.10, King County, Washington",621,118,11,17,0,12,11,17,610,117,109,72,501,117
1500000US530330320111,530330320111,"Block Group 1, Census Tract 320.11, King County, Washington",819,83,51,38,0,12,51,38,768,89,102,54,666,94
1500000US530330320112,530330320112,"Block Group 2, Census Tract 320.11, King County, Washington",540,74,15,26,15,26,0,12,525,71,28,29,497,74
1500000US530330321021,530330321021,"Block Group 1, Census Tract 321.02, King County, Washington",569,77,0,12,0,12,0,12,569,77,89,49,480,82
1500000US530330321022,530330321022,"Block Group 2, Census Tract 321.02, King County, Washington",290,65,12,18,12,18,0,12,278,64,75,43,203,57
1500000US530330321023,530330321023,"Block Group 3, Census Tract 321.02, King County, Washington",466,85,0,12,0,12,0,12,466,85,68,51,398,87
1500000US530330321024,530330321024,"Block Group 4, Census Tract 321.02, King County, Washington",565,83,0,12,0,12,0,12,565,83,111,45,454,88
1500000US530330321031,530330321031,"Block Group 1, Census Tract 321.03, King County, Washington",253,72,9,17,9,17,0,12,244,73,47,44,197,70
1500000US530330321032,530330321032,"Block Group 2, Census Tract 321.03, King County, Washington",430,107,42,57,8,12,34,56,388,107,61,49,327,98
1500000US530330321033,530330321033,"Block Group 3, Census Tract 321.03, King County, Washington",688,167,58,60,58,60,0,12,630,165,93,71,537,170
1500000US530330321034,530330321034,"Block Group 4, Census Tract 321.03, King County, Washington",604,139,0,12,0,12,0,12,604,139,93,77,511,126
1500000US530330321041,530330321041,"Block Group 1, Census Tract 321.04, King County, Washington",941,134,18,26,18,26,0,12,923,131,140,65,783,142
1500000US530330321042,530330321042,"Block Group 2, Census Tract 321.04, King County, Washington",867,153,98,81,0,12,98,81,769,170,74,51,695,168
1500000US530330321043,530330321043,"Block Group 3, Census Tract 321.04, King County, Washington",727,151,157,120,85,81,72,96,570,132,13,21,557,133
1500000US530330322031,530330322031,"Block Group 1, Census Tract 322.03, King County, Washington",503,96,19,30,0,12,19,30,484,95,31,35,453,93
1500000US530330322032,530330322032,"Block Group 2, Census Tract 322.03, King County, Washington",464,98,0,12,0,12,0,12,464,98,62,54,402,110
1500000US530330322033,530330322033,"Block Group 3, Census Tract 322.03, King County, Washington",890,134,0,12,0,12,0,12,890,134,73,45,817,139
1500000US530330322034,530330322034,"Block Group 4, Census Tract 322.03, King County, Washington",513,84,0,12,0,12,0,12,513,84,89,64,424,96
1500000US530330322071,530330322071,"Block Group 1, Census Tract 322.07, King County, Washington",347,46,0,12,0,12,0,12,347,46,37,23,310,48
1500000US530330322072,530330322072,"Block Group 2, Census Tract 322.07, King County, Washington",327,56,0,12,0,12,0,12,327,56,67,38,260,56
1500000US530330322073,530330322073,"Block Group 3, Census Tract 322.07, King County, Washington",439,72,0,12,0,12,0,12,439,72,40,27,399,74
1500000US530330322081,530330322081,"Block Group 1, Census Tract 322.08, King County, Washington",520,95,17,27,0,12,17,27,503,95,123,66,380,85
1500000US530330322082,530330322082,"Block Group 2, Census Tract 322.08, King County, Washington",747,104,0,12,0,12,0,12,747,104,332,96,415,123
1500000US530330322083,530330322083,"Block Group 3, Census Tract 322.08, King County, Washington",923,152,0,12,0,12,0,12,923,152,226,116,697,135
1500000US530330322084,530330322084,"Block Group 4, Census Tract 322.08, King County, Washington",850,145,48,45,19,30,29,35,802,150,40,36,762,154
1500000US530330322085,530330322085,"Block Group 5, Census Tract 322.08, King County, Washington",718,119,0,12,0,12,0,12,718,119,132,84,586,102
1500000US530330322101,530330322101,"Block Group 1, Census Tract 322.10, King County, Washington",572,128,16,25,0,12,16,25,556,128,45,43,511,127
1500000US530330322102,530330322102,"Block Group 2, Census Tract 322.10, King County, Washington",1749,225,41,52,0,17,41,52,1708,221,102,64,1606,223
1500000US530330322103,530330322103,"Block Group 3, Census Tract 322.10, King County, Washington",1571,246,0,12,0,12,0,12,1571,246,220,127,1351,238
1500000US530330322111,530330322111,"Block Group 1, Census Tract 322.11, King County, Washington",621,80,10,15,0,12,10,15,611,81,64,46,547,79
1500000US530330322112,530330322112,"Block Group 2, Census Tract 322.11, King County, Washington",635,91,0,12,0,12,0,12,635,91,35,29,600,97
1500000US530330322113,530330322113,"Block Group 3, Census Tract 322.11, King County, Washington",581,76,12,19,0,12,12,19,569,76,19,20,550,80
1500000US530330322121,530330322121,"Block Group 1, Census Tract 322.12, King County, Washington",999,140,0,12,0,12,0,12,999,140,63,48,936,145
1500000US530330322122,530330322122,"Block Group 2, Census Tract 322.12, King County, Washington",345,83,25,29,15,24,10,17,320,92,0,12,320,92
1500000US530330322123,530330322123,"Block Group 3, Census Tract 322.12, King County, Washington",505,85,0,12,0,12,0,12,505,85,0,12,505,85
1500000US530330322124,530330322124,"Block Group 4, Census Tract 322.12, King County, Washington",1263,162,101,109,40,47,61,98,1162,179,85,60,1077,172
1500000US530330322131,530330322131,"Block Group 1, Census Tract 322.13, King County, Washington",305,88,0,12,0,12,0,12,305,88,48,47,257,85
1500000US530330322132,530330322132,"Block Group 2, Census Tract 322.13, King County, Washington",273,66,0,12,0,12,0,12,273,66,52,44,221,73
1500000US530330322133,530330322133,"Block Group 3, Census Tract 322.13, King County, Washington",831,107,42,59,0,12,42,59,789,116,62,41,727,114
1500000US530330322141,530330322141,"Block Group 1, Census Tract 322.14, King County, Washington",542,100,23,37,23,37,0,12,519,98,37,35,482,101
1500000US530330322142,530330322142,"Block Group 2, Census Tract 322.14, King County, Washington",860,95,0,12,0,12,0,12,860,95,120,73,740,104
1500000US530330322143,530330322143,"Block Group 3, Census Tract 322.14, King County, Washington",607,100,0,12,0,12,0,12,607,100,102,79,505,105
1500000US530330322151,530330322151,"Block Group 1, Census Tract 322.15, King County, Washington",521,86,0,12,0,12,0,12,521,86,18,23,503,89
1500000US530330322152,530330322152,"Block Group 2, Census Tract 322.15, King County, Washington",867,89,0,12,0,12,0,12,867,89,31,36,836,90
1500000US530330323071,530330323071,"Block Group 1, Census Tract 323.07, King County, Washington",657,108,16,26,0,12,16,26,641,117,73,72,568,126
1500000US530330323072,530330323072,"Block Group 2, Census Tract 323.07, King County, Washington",419,85,0,12,0,12,0,12,419,85,43,40,376,95
1500000US530330323073,530330323073,"Block Group 3, Census Tract 323.07, King County, Washington",516,90,0,12,0,12,0,12,516,90,70,44,446,96
1500000US530330323074,530330323074,"Block Group 4, Census Tract 323.07, King County, Washington",493,117,0,12,0,12,0,12,493,117,39,38,454,117
1500000US530330323075,530330323075,"Block Group 5, Census Tract 323.07, King County, Washington",367,57,13,22,0,12,13,22,354,61,12,21,342,61
1500000US530330323091,530330323091,"Block Group 1, Census Tract 323.09, King County, Washington",674,158,0,12,0,12,0,12,674,158,116,85,558,153
1500000US530330323092,530330323092,"Block Group 2, Census Tract 323.09, King County, Washington",1376,202,66,42,66,42,0,12,1310,198,93,55,1217,198
1500000US530330323093,530330323093,"Block Group 3, Census Tract 323.09, King County, Washington",752,116,28,36,20,31,8,14,724,116,54,40,670,121
1500000US530330323111,530330323111,"Block Group 1, Census Tract 323.11, King County, Washington",376,82,0,12,0,12,0,12,376,82,36,39,340,89
1500000US530330323112,530330323112,"Block Group 2, Census Tract 323.11, King County, Washington",515,105,42,62,0,12,42,62,473,94,64,64,409,98
1500000US530330323113,530330323113,"Block Group 3, Census Tract 323.11, King County, Washington",330,72,0,12,0,12,0,12,330,72,82,57,248,66
1500000US530330323114,530330323114,"Block Group 4, Census Tract 323.11, King County, Washington",523,100,0,12,0,12,0,12,523,100,36,36,487,96
1500000US530330323115,530330323115,"Block Group 5, Census Tract 323.11, King County, Washington",351,124,0,12,0,12,0,12,351,124,10,17,341,126
1500000US530330323131,530330323131,"Block Group 1, Census Tract 323.13, King County, Washington",361,58,0,12,0,12,0,12,361,58,57,42,304,62
1500000US530330323132,530330323132,"Block Group 2, Census Tract 323.13, King County, Washington",619,97,43,55,43,55,0,12,576,106,122,65,454,105
1500000US530330323133,530330323133,"Block Group 3, Census Tract 323.13, King County, Washington",182,63,0,12,0,12,0,12,182,63,48,59,134,54
1500000US530330323134,530330323134,"Block Group 4, Census Tract 323.13, King County, Washington",1410,157,75,71,23,27,52,66,1335,162,87,54,1248,169
1500000US530330323151,530330323151,"Block Group 1, Census Tract 323.15, King County, Washington",815,105,20,22,0,12,20,22,795,109,105,53,690,117
1500000US530330323152,530330323152,"Block Group 2, Census Tract 323.15, King County, Washington",551,111,12,19,0,12,12,19,539,114,70,45,469,116
1500000US530330323153,530330323153,"Block Group 3, Census Tract 323.15, King County, Washington",718,107,62,68,0,12,62,68,656,102,69,39,587,105
1500000US530330323161,530330323161,"Block Group 1, Census Tract 323.16, King County, Washington",314,65,9,13,9,13,0,12,305,64,51,35,254,68
1500000US530330323162,530330323162,"Block Group 2, Census Tract 323.16, King County, Washington",502,58,0,12,0,12,0,12,502,58,48,35,454,61
1500000US530330323163,530330323163,"Block Group 3, Census Tract 323.16, King County, Washington",553,74,0,12,0,12,0,12,553,74,43,31,510,75
1500000US530330323164,530330323164,"Block Group 4, Census Tract 323.16, King County, Washington",443,68,0,12,0,12,0,12,443,68,9,16,434,68
1500000US530330323171,530330323171,"Block Group 1, Census Tract 323.17, King County, Washington",502,68,36,50,0,12,36,50,466,69,55,35,411,75
1500000US530330323172,530330323172,"Block Group 2, Census Tract 323.17, King County, Washington",452,75,0,12,0,12,0,12,452,75,37,40,415,82
1500000US530330323173,530330323173,"Block Group 3, Census Tract 323.17, King County, Washington",447,88,112,100,59,87,53,61,335,89,12,19,323,91
1500000US530330323174,530330323174,"Block Group 4, Census Tract 323.17, King County, Washington",352,58,0,12,0,12,0,12,352,58,80,54,272,65
1500000US530330323175,530330323175,"Block Group 5, Census Tract 323.17, King County, Washington",409,71,0,12,0,12,0,12,409,71,30,33,379,76
1500000US530330323181,530330323181,"Block Group 1, Census Tract 323.18, King County, Washington",724,76,0,12,0,12,0,12,724,76,61,40,663,86
1500000US530330323182,530330323182,"Block Group 2, Census Tract 323.18, King County, Washington",333,61,0,12,0,12,0,12,333,61,16,18,317,64
1500000US530330323183,530330323183,"Block Group 3, Census Tract 323.18, King County, Washington",292,48,0,12,0,12,0,12,292,48,19,22,273,50
1500000US530330323184,530330323184,"Block Group 4, Census Tract 323.18, King County, Washington",504,87,0,12,0,12,0,12,504,87,54,38,450,91
1500000US530330323191,530330323191,"Block Group 1, Census Tract 323.19, King County, Washington",197,54,12,20,12,20,0,12,185,55,15,26,170,55
1500000US530330323192,530330323192,"Block Group 2, Census Tract 323.19, King County, Washington",639,127,0,12,0,12,0,12,639,127,122,70,517,128
1500000US530330323193,530330323193,"Block Group 3, Census Tract 323.19, King County, Washington",917,182,159,105,42,39,117,100,758,177,106,61,652,181
1500000US530330323194,530330323194,"Block Group 4, Census Tract 323.19, King County, Washington",633,136,33,38,33,38,0,12,600,136,112,96,488,135
1500000US530330323201,530330323201,"Block Group 1, Census Tract 323.20, King County, Washington",421,68,9,15,9,15,0,12,412,70,82,38,330,73
1500000US530330323202,530330323202,"Block Group 2, Census Tract 323.20, King County, Washington",478,102,0,12,0,12,0,12,478,102,97,69,381,81
1500000US530330323203,530330323203,"Block Group 3, Census Tract 323.20, King County, Washington",539,87,0,12,0,12,0,12,539,87,20,22,519,86
1500000US530330323211,530330323211,"Block Group 1, Census Tract 323.21, King County, Washington",300,82,0,12,0,12,0,12,300,82,38,30,262,82
1500000US530330323212,530330323212,"Block Group 2, Census Tract 323.21, King County, Washington",465,89,31,42,31,42,0,12,434,91,42,37,392,91
1500000US530330323213,530330323213,"Block Group 3, Census Tract 323.21, King County, Washington",538,86,0,12,0,12,0,12,538,86,52,33,486,85
1500000US530330323214,530330323214,"Block Group 4, Census Tract 323.21, King County, Washington",400,60,0,12,0,12,0,12,400,60,0,12,400,60
1500000US530330323221,530330323221,"Block Group 1, Census Tract 323.22, King County, Washington",450,51,10,15,10,15,0,12,440,53,48,31,392,58
1500000US530330323222,530330323222,"Block Group 2, Census Tract 323.22, King County, Washington",274,52,0,12,0,12,0,12,274,52,27,24,247,56
1500000US530330323223,530330323223,"Block Group 3, Census Tract 323.22, King County, Washington",495,71,19,28,0,12,19,28,476,72,0,12,476,72
1500000US530330323231,530330323231,"Block Group 1, Census Tract 323.23, King County, Washington",531,110,0,12,0,12,0,12,531,110,89,66,442,97
1500000US530330323232,530330323232,"Block Group 2, Census Tract 323.23, King County, Washington",599,92,7,13,7,13,0,12,592,92,190,71,402,97
1500000US530330323233,530330323233,"Block Group 3, Census Tract 323.23, King County, Washington",566,93,0,12,0,12,0,12,566,93,106,67,460,102
1500000US530330323234,530330323234,"Block Group 4, Census Tract 323.23, King County, Washington",479,94,0,12,0,12,0,12,479,94,38,39,441,95
1500000US530330323241,530330323241,"Block Group 1, Census Tract 323.24, King County, Washington",333,76,14,21,14,21,0,12,319,74,48,47,271,79
1500000US530330323242,530330323242,"Block Group 2, Census Tract 323.24, King County, Washington",503,112,83,93,0,12,83,93,420,94,100,85,320,109
1500000US530330323243,530330323243,"Block Group 3, Census Tract 323.24, King County, Washington",928,132,89,41,49,29,40,38,839,129,33,50,806,137
1500000US530330323244,530330323244,"Block Group 4, Census Tract 323.24, King County, Washington",439,82,11,19,0,12,11,19,428,84,41,41,387,86
1500000US530330323251,530330323251,"Block Group 1, Census Tract 323.25, King County, Washington",138,46,0,12,0,12,0,12,138,46,0,12,138,46
1500000US530330323252,530330323252,"Block Group 2, Census Tract 323.25, King County, Washington",1108,161,35,41,35,41,0,12,1073,159,87,59,986,161
1500000US530330323253,530330323253,"Block Group 3, Census Tract 323.25, King County, Washington",1327,172,16,24,16,24,0,12,1311,179,34,39,1277,175
1500000US530330323261,530330323261,"Block Group 1, Census Tract 323.26, King County, Washington",465,84,0,12,0,12,0,12,465,84,37,34,428,88
1500000US530330323262,530330323262,"Block Group 2, Census Tract 323.26, King County, Washington",641,96,0,12,0,12,0,12,641,96,178,69,463,98
1500000US530330323263,530330323263,"Block Group 3, Census Tract 323.26, King County, Washington",336,95,19,29,0,12,19,29,317,92,50,49,267,97
1500000US530330323271,530330323271,"Block Group 1, Census Tract 323.27, King County, Washington",1772,154,25,34,25,34,0,12,1747,148,369,113,1378,161
1500000US530330323272,530330323272,"Block Group 2, Census Tract 323.27, King County, Washington",255,75,0,12,0,12,0,12,255,75,14,20,241,77
1500000US530330323281,530330323281,"Block Group 1, Census Tract 323.28, King County, Washington",402,92,0,12,0,12,0,12,402,92,59,51,343,88
1500000US530330323282,530330323282,"Block Group 2, Census Tract 323.28, King County, Washington",438,106,0,12,0,12,0,12,438,106,91,60,347,117
1500000US530330323283,530330323283,"Block Group 3, Census Tract 323.28, King County, Washington",373,101,0,12,0,12,0,12,373,101,20,31,353,97
1500000US530330323291,530330323291,"Block Group 1, Census Tract 323.29, King County, Washington",1143,110,16,26,0,12,16,26,1127,109,133,92,994,125
1500000US530330323292,530330323292,"Block Group 2, Census Tract 323.29, King County, Washington",1710,170,59,55,0,12,59,55,1651,170,195,94,1456,187
1500000US530330324011,530330324011,"Block Group 1, Census Tract 324.01, King County, Washington",625,140,0,12,0,12,0,12,625,140,76,57,549,148
1500000US530330324012,530330324012,"Block Group 2, Census Tract 324.01, King County, Washington",671,114,17,28,17,28,0,12,654,123,88,77,566,129
1500000US530330324013,530330324013,"Block Group 3, Census Tract 324.01, King County, Washington",375,114,14,18,14,18,0,12,361,117,18,24,343,117
1500000US530330324014,530330324014,"Block Group 4, Census Tract 324.01, King County, Washington",467,106,0,12,0,12,0,12,467,106,130,102,337,102
1500000US530330324021,530330324021,"Block Group 1, Census Tract 324.02, King County, Washington",757,100,19,21,9,15,10,15,738,101,95,72,643,110
1500000US530330324022,530330324022,"Block Group 2, Census Tract 324.02, King County, Washington",653,111,20,23,20,23,0,12,633,111,92,77,541,110
1500000US530330324023,530330324023,"Block Group 3, Census Tract 324.02, King County, Washington",445,105,0,12,0,12,0,12,445,105,83,50,362,107
1500000US530330324024,530330324024,"Block Group 4, Census Tract 324.02, King County, Washington",230,72,15,31,0,12,15,31,215,72,47,38,168,68
1500000US530330325001,530330325001,"Block Group 1, Census Tract 325, King County, Washington",477,95,11,16,0,12,11,16,466,95,78,37,388,103
1500000US530330325002,530330325002,"Block Group 2, Census Tract 325, King County, Washington",588,67,12,18,12,18,0,12,576,70,127,62,449,77
1500000US530330325003,530330325003,"Block Group 3, Census Tract 325, King County, Washington",388,66,38,27,25,21,13,16,350,65,76,35,274,70
1500000US530330325004,530330325004,"Block Group 4, Census Tract 325, King County, Washington",562,87,17,17,0,12,17,17,545,91,81,31,464,86
1500000US530330326011,530330326011,"Block Group 1, Census Tract 326.01, King County, Washington",749,99,29,31,13,17,16,25,720,105,188,90,532,118
1500000US530330326012,530330326012,"Block Group 2, Census Tract 326.01, King County, Washington",401,89,0,12,0,12,0,12,401,89,75,41,326,97
1500000US530330326021,530330326021,"Block Group 1, Census Tract 326.02, King County, Washington",921,152,35,40,22,34,13,22,886,160,117,94,769,161
1500000US530330326022,530330326022,"Block Group 2, Census Tract 326.02, King County, Washington",356,101,44,72,0,12,44,72,312,88,59,43,253,96
1500000US530330326023,530330326023,"Block Group 3, Census Tract 326.02, King County, Washington",1391,164,119,106,39,63,80,88,1272,195,98,87,1174,207
1500000US530330326024,530330326024,"Block Group 4, Census Tract 326.02, King County, Washington",1131,158,34,52,0,12,34,52,1097,156,78,73,1019,161
1500000US530330327021,530330327021,"Block Group 1, Census Tract 327.02, King County, Washington",607,92,13,19,0,12,13,19,594,96,25,29,569,100
1500000US530330327022,530330327022,"Block Group 2, Census Tract 327.02, King County, Washington",439,83,0,12,0,12,0,12,439,83,60,42,379,81
1500000US530330327023,530330327023,"Block Group 3, Census Tract 327.02, King County, Washington",400,86,14,21,0,12,14,21,386,88,42,40,344,93
1500000US530330327024,530330327024,"Block Group 4, Census Tract 327.02, King County, Washington",367,123,0,12,0,12,0,12,367,123,12,20,355,121
1500000US530330327025,530330327025,"Block Group 5, Census Tract 327.02, King County, Washington",434,139,0,12,0,12,0,12,434,139,89,104,345,106
1500000US530330327026,530330327026,"Block Group 6, Census Tract 327.02, King County, Washington",352,80,24,27,12,19,12,19,328,85,73,46,255,87
1500000US530330327031,530330327031,"Block Group 1, Census Tract 327.03, King County, Washington",375,67,0,12,0,12,0,12,375,67,52,32,323,74
1500000US530330327032,530330327032,"Block Group 2, Census Tract 327.03, King County, Washington",365,78,48,38,16,16,32,37,317,73,37,24,280,76
1500000US530330327041,530330327041,"Block Group 1, Census Tract 327.04, King County, Washington",486,109,39,36,27,30,12,21,447,105,140,72,307,88
1500000US530330327042,530330327042,"Block Group 2, Census Tract 327.04, King County, Washington",576,116,45,71,0,12,45,71,531,104,78,59,453,116
1500000US530330327043,530330327043,"Block Group 3, Census Tract 327.04, King County, Washington",588,130,27,31,17,28,10,17,561,140,121,77,440,126
1500000US530330327044,530330327044,"Block Group 4, Census Tract 327.04, King County, Washington",677,158,163,112,74,76,89,87,514,151,144,95,370,136
1500000US530330328001,530330328001,"Block Group 1, Census Tract 328, King County, Washington",273,71,11,17,11,17,0,12,262,71,37,26,225,71
1500000US530330328002,530330328002,"Block Group 2, Census Tract 328, King County, Washington",605,78,0,12,0,12,0,12,605,78,81,41,524,85
1500000US530330328003,530330328003,"Block Group 3, Census Tract 328, King County, Washington",281,71,35,24,24,19,11,13,246,72,87,45,159,56
1500000US530339901000,530339901000,"Block Group 0, Census Tract 9901, King County, Washington",0,12,0,12,0,12,0,12,0,12,0,12,0,12
