Id,Id2,Geography,Tenure Total,Margin of Error; Total:,Own,Margin of Error; Total: - Owner occupied,Rent,Margin of Error; Total: - Renter occupied
1500000US530330001001,530330001001,"Block Group 1, Census Tract 1, King County, Washington",629,95,589,104,40,45
1500000US530330001002,530330001002,"Block Group 2, Census Tract 1, King County, Washington",760,139,111,53,649,143
1500000US530330001003,530330001003,"Block Group 3, Census Tract 1, King County, Washington",684,110,318,89,366,109
1500000US530330001004,530330001004,"Block Group 4, Census Tract 1, King County, Washington",928,160,37,34,891,167
1500000US530330001005,530330001005,"Block Group 5, Census Tract 1, King County, Washington",546,111,87,49,459,107
1500000US530330002001,530330002001,"Block Group 1, Census Tract 2, King County, Washington",471,93,379,91,92,68
1500000US530330002002,530330002002,"Block Group 2, Census Tract 2, King County, Washington",468,142,249,83,219,116
1500000US530330002003,530330002003,"Block Group 3, Census Tract 2, King County, Washington",835,130,163,69,672,141
1500000US530330002004,530330002004,"Block Group 4, Census Tract 2, King County, Washington",541,95,331,75,210,110
1500000US530330002005,530330002005,"Block Group 5, Census Tract 2, King County, Washington",754,131,381,96,373,109
1500000US530330002006,530330002006,"Block Group 6, Census Tract 2, King County, Washington",484,83,484,83,0,12
1500000US530330003001,530330003001,"Block Group 1, Census Tract 3, King County, Washington",519,62,332,74,187,67
1500000US530330003002,530330003002,"Block Group 2, Census Tract 3, King County, Washington",657,64,353,87,304,87
1500000US530330004011,530330004011,"Block Group 1, Census Tract 4.01, King County, Washington",1972,190,344,111,1628,201
1500000US530330004012,530330004012,"Block Group 2, Census Tract 4.01, King County, Washington",684,149,336,75,348,157
1500000US530330004013,530330004013,"Block Group 3, Census Tract 4.01, King County, Washington",886,133,209,85,677,131
1500000US530330004021,530330004021,"Block Group 1, Census Tract 4.02, King County, Washington",554,112,175,72,379,104
1500000US530330004022,530330004022,"Block Group 2, Census Tract 4.02, King County, Washington",383,81,273,76,110,62
1500000US530330004023,530330004023,"Block Group 3, Census Tract 4.02, King County, Washington",664,139,290,116,374,129
1500000US530330004024,530330004024,"Block Group 4, Census Tract 4.02, King County, Washington",791,118,353,99,438,101
1500000US530330005001,530330005001,"Block Group 1, Census Tract 5, King County, Washington",466,54,450,53,16,17
1500000US530330005002,530330005002,"Block Group 2, Census Tract 5, King County, Washington",363,48,353,48,10,14
1500000US530330005003,530330005003,"Block Group 3, Census Tract 5, King County, Washington",422,55,375,60,47,34
1500000US530330006001,530330006001,"Block Group 1, Census Tract 6, King County, Washington",445,75,399,77,46,33
1500000US530330006002,530330006002,"Block Group 2, Census Tract 6, King County, Washington",536,114,189,67,347,113
1500000US530330006003,530330006003,"Block Group 3, Census Tract 6, King County, Washington",684,141,268,82,416,132
1500000US530330006004,530330006004,"Block Group 4, Census Tract 6, King County, Washington",769,114,439,94,330,119
1500000US530330006005,530330006005,"Block Group 5, Census Tract 6, King County, Washington",336,90,221,69,115,91
1500000US530330006006,530330006006,"Block Group 6, Census Tract 6, King County, Washington",653,127,229,87,424,129
1500000US530330007001,530330007001,"Block Group 1, Census Tract 7, King County, Washington",1008,125,349,117,659,135
1500000US530330007002,530330007002,"Block Group 2, Census Tract 7, King County, Washington",445,93,218,73,227,91
1500000US530330007003,530330007003,"Block Group 3, Census Tract 7, King County, Washington",456,88,333,73,123,82
1500000US530330007004,530330007004,"Block Group 4, Census Tract 7, King County, Washington",279,71,173,62,106,56
1500000US530330008001,530330008001,"Block Group 1, Census Tract 8, King County, Washington",499,62,362,54,137,57
1500000US530330008002,530330008002,"Block Group 2, Census Tract 8, King County, Washington",541,63,384,65,157,60
1500000US530330009001,530330009001,"Block Group 1, Census Tract 9, King County, Washington",445,48,375,47,70,28
1500000US530330009002,530330009002,"Block Group 2, Census Tract 9, King County, Washington",405,43,377,46,28,25
1500000US530330010001,530330010001,"Block Group 1, Census Tract 10, King County, Washington",331,54,172,34,159,55
1500000US530330010002,530330010002,"Block Group 2, Census Tract 10, King County, Washington",431,53,281,42,150,54
1500000US530330011001,530330011001,"Block Group 1, Census Tract 11, King County, Washington",501,85,384,75,117,71
1500000US530330011002,530330011002,"Block Group 2, Census Tract 11, King County, Washington",584,74,393,68,191,70
1500000US530330012001,530330012001,"Block Group 1, Census Tract 12, King County, Washington",488,92,403,93,85,53
1500000US530330012002,530330012002,"Block Group 2, Census Tract 12, King County, Washington",467,160,112,54,355,150
1500000US530330012003,530330012003,"Block Group 3, Census Tract 12, King County, Washington",1103,175,193,60,910,167
1500000US530330012004,530330012004,"Block Group 4, Census Tract 12, King County, Washington",758,144,87,62,671,146
1500000US530330012005,530330012005,"Block Group 5, Census Tract 12, King County, Washington",805,187,154,73,651,184
1500000US530330013001,530330013001,"Block Group 1, Census Tract 13, King County, Washington",807,105,338,92,469,103
1500000US530330013002,530330013002,"Block Group 2, Census Tract 13, King County, Washington",640,111,328,120,312,105
1500000US530330013003,530330013003,"Block Group 3, Census Tract 13, King County, Washington",719,103,261,78,458,114
1500000US530330014001,530330014001,"Block Group 1, Census Tract 14, King County, Washington",588,113,348,109,240,97
1500000US530330014002,530330014002,"Block Group 2, Census Tract 14, King County, Washington",463,100,263,82,200,95
1500000US530330014003,530330014003,"Block Group 3, Census Tract 14, King County, Washington",603,107,234,81,369,103
1500000US530330014004,530330014004,"Block Group 4, Census Tract 14, King County, Washington",635,93,505,100,130,109
1500000US530330015001,530330015001,"Block Group 1, Census Tract 15, King County, Washington",514,66,367,59,147,71
1500000US530330015002,530330015002,"Block Group 2, Census Tract 15, King County, Washington",589,71,491,71,98,47
1500000US530330016001,530330016001,"Block Group 1, Census Tract 16, King County, Washington",612,62,612,62,0,12
1500000US530330016002,530330016002,"Block Group 2, Census Tract 16, King County, Washington",524,62,470,61,54,46
1500000US530330016003,530330016003,"Block Group 3, Census Tract 16, King County, Washington",680,101,364,71,316,85
1500000US530330017011,530330017011,"Block Group 1, Census Tract 17.01, King County, Washington",864,110,244,79,620,108
1500000US530330017012,530330017012,"Block Group 2, Census Tract 17.01, King County, Washington",510,81,301,78,209,56
1500000US530330017013,530330017013,"Block Group 3, Census Tract 17.01, King County, Washington",568,84,377,89,191,72
1500000US530330017021,530330017021,"Block Group 1, Census Tract 17.02, King County, Washington",878,104,368,119,510,108
1500000US530330017022,530330017022,"Block Group 2, Census Tract 17.02, King County, Washington",570,97,399,84,171,81
1500000US530330017023,530330017023,"Block Group 3, Census Tract 17.02, King County, Washington",414,84,224,63,190,95
1500000US530330017024,530330017024,"Block Group 4, Census Tract 17.02, King County, Washington",281,64,238,63,43,40
1500000US530330018001,530330018001,"Block Group 1, Census Tract 18, King County, Washington",673,122,381,94,292,132
1500000US530330018002,530330018002,"Block Group 2, Census Tract 18, King County, Washington",684,145,227,73,457,135
1500000US530330018003,530330018003,"Block Group 3, Census Tract 18, King County, Washington",879,162,481,158,398,146
1500000US530330019001,530330019001,"Block Group 1, Census Tract 19, King County, Washington",1232,95,579,93,653,105
1500000US530330019002,530330019002,"Block Group 2, Census Tract 19, King County, Washington",540,67,383,71,157,54
1500000US530330019003,530330019003,"Block Group 3, Census Tract 19, King County, Washington",461,58,322,59,139,45
1500000US530330020001,530330020001,"Block Group 1, Census Tract 20, King County, Washington",826,86,414,64,412,95
1500000US530330020002,530330020002,"Block Group 2, Census Tract 20, King County, Washington",452,59,307,60,145,51
1500000US530330020003,530330020003,"Block Group 3, Census Tract 20, King County, Washington",315,53,241,55,74,38
1500000US530330021001,530330021001,"Block Group 1, Census Tract 21, King County, Washington",640,71,520,72,120,43
1500000US530330021002,530330021002,"Block Group 2, Census Tract 21, King County, Washington",415,74,309,68,106,61
1500000US530330021003,530330021003,"Block Group 3, Census Tract 21, King County, Washington",685,82,349,74,336,83
1500000US530330022001,530330022001,"Block Group 1, Census Tract 22, King County, Washington",575,75,460,82,115,76
1500000US530330022002,530330022002,"Block Group 2, Census Tract 22, King County, Washington",528,64,488,68,40,30
1500000US530330022003,530330022003,"Block Group 3, Census Tract 22, King County, Washington",570,84,447,73,123,56
1500000US530330022004,530330022004,"Block Group 4, Census Tract 22, King County, Washington",529,66,529,66,0,12
1500000US530330024001,530330024001,"Block Group 1, Census Tract 24, King County, Washington",362,56,308,54,54,41
1500000US530330024002,530330024002,"Block Group 2, Census Tract 24, King County, Washington",316,54,165,46,151,47
1500000US530330024003,530330024003,"Block Group 3, Census Tract 24, King County, Washington",579,69,468,77,111,45
1500000US530330025001,530330025001,"Block Group 1, Census Tract 25, King County, Washington",653,62,511,69,142,62
1500000US530330025002,530330025002,"Block Group 2, Census Tract 25, King County, Washington",618,68,379,56,239,75
1500000US530330026001,530330026001,"Block Group 1, Census Tract 26, King County, Washington",497,83,284,73,213,71
1500000US530330026002,530330026002,"Block Group 2, Census Tract 26, King County, Washington",512,68,398,69,114,53
1500000US530330026003,530330026003,"Block Group 3, Census Tract 26, King County, Washington",549,73,323,74,226,63
1500000US530330026004,530330026004,"Block Group 4, Census Tract 26, King County, Washington",361,61,240,52,121,50
1500000US530330027001,530330027001,"Block Group 1, Census Tract 27, King County, Washington",726,111,453,128,273,87
1500000US530330027002,530330027002,"Block Group 2, Census Tract 27, King County, Washington",600,101,479,106,121,88
1500000US530330027003,530330027003,"Block Group 3, Census Tract 27, King County, Washington",454,94,324,92,130,65
1500000US530330027004,530330027004,"Block Group 4, Census Tract 27, King County, Washington",630,84,455,90,175,67
1500000US530330028001,530330028001,"Block Group 1, Census Tract 28, King County, Washington",369,81,287,74,82,52
1500000US530330028002,530330028002,"Block Group 2, Census Tract 28, King County, Washington",490,69,217,73,273,74
1500000US530330028003,530330028003,"Block Group 3, Census Tract 28, King County, Washington",615,111,317,77,298,110
1500000US530330028004,530330028004,"Block Group 4, Census Tract 28, King County, Washington",645,93,409,93,236,96
1500000US530330029001,530330029001,"Block Group 1, Census Tract 29, King County, Washington",676,84,445,68,231,82
1500000US530330029002,530330029002,"Block Group 2, Census Tract 29, King County, Washington",656,68,393,67,263,67
1500000US530330029003,530330029003,"Block Group 3, Census Tract 29, King County, Washington",552,68,361,65,191,73
1500000US530330030001,530330030001,"Block Group 1, Census Tract 30, King County, Washington",626,87,479,88,147,68
1500000US530330030002,530330030002,"Block Group 2, Census Tract 30, King County, Washington",589,100,433,83,156,99
1500000US530330030003,530330030003,"Block Group 3, Census Tract 30, King County, Washington",659,103,430,100,229,88
1500000US530330030004,530330030004,"Block Group 4, Census Tract 30, King County, Washington",611,121,348,100,263,128
1500000US530330031001,530330031001,"Block Group 1, Census Tract 31, King County, Washington",444,73,356,83,88,54
1500000US530330031002,530330031002,"Block Group 2, Census Tract 31, King County, Washington",493,120,429,129,64,54
1500000US530330031003,530330031003,"Block Group 3, Census Tract 31, King County, Washington",600,122,401,98,199,97
1500000US530330031004,530330031004,"Block Group 4, Census Tract 31, King County, Washington",621,94,493,87,128,63
1500000US530330031005,530330031005,"Block Group 5, Census Tract 31, King County, Washington",515,74,437,82,78,55
1500000US530330032001,530330032001,"Block Group 1, Census Tract 32, King County, Washington",500,120,195,69,305,133
1500000US530330032002,530330032002,"Block Group 2, Census Tract 32, King County, Washington",895,178,215,87,680,186
1500000US530330032003,530330032003,"Block Group 3, Census Tract 32, King County, Washington",563,115,227,85,336,120
1500000US530330032004,530330032004,"Block Group 4, Census Tract 32, King County, Washington",652,156,144,71,508,142
1500000US530330032005,530330032005,"Block Group 5, Census Tract 32, King County, Washington",234,60,188,66,46,31
1500000US530330032006,530330032006,"Block Group 6, Census Tract 32, King County, Washington",725,151,575,136,150,125
1500000US530330032007,530330032007,"Block Group 7, Census Tract 32, King County, Washington",481,133,454,132,27,34
1500000US530330033001,530330033001,"Block Group 1, Census Tract 33, King County, Washington",638,77,432,74,206,77
1500000US530330033002,530330033002,"Block Group 2, Census Tract 33, King County, Washington",445,90,259,89,186,76
1500000US530330033003,530330033003,"Block Group 3, Census Tract 33, King County, Washington",910,125,352,101,558,132
1500000US530330033004,530330033004,"Block Group 4, Census Tract 33, King County, Washington",663,128,242,105,421,110
1500000US530330033005,530330033005,"Block Group 5, Census Tract 33, King County, Washington",549,112,252,68,297,110
1500000US530330034001,530330034001,"Block Group 1, Census Tract 34, King County, Washington",544,65,292,53,252,74
1500000US530330034002,530330034002,"Block Group 2, Census Tract 34, King County, Washington",519,87,410,71,109,59
1500000US530330034003,530330034003,"Block Group 3, Census Tract 34, King County, Washington",441,58,261,61,180,50
1500000US530330035001,530330035001,"Block Group 1, Census Tract 35, King County, Washington",628,68,333,69,295,62
1500000US530330035002,530330035002,"Block Group 2, Census Tract 35, King County, Washington",689,82,387,72,302,87
1500000US530330035003,530330035003,"Block Group 3, Census Tract 35, King County, Washington",559,97,313,64,246,79
1500000US530330036001,530330036001,"Block Group 1, Census Tract 36, King County, Washington",736,115,166,68,570,130
1500000US530330036002,530330036002,"Block Group 2, Census Tract 36, King County, Washington",785,142,168,80,617,149
1500000US530330036003,530330036003,"Block Group 3, Census Tract 36, King County, Washington",620,89,491,85,129,54
1500000US530330036004,530330036004,"Block Group 4, Census Tract 36, King County, Washington",1197,177,112,68,1085,188
1500000US530330038001,530330038001,"Block Group 1, Census Tract 38, King County, Washington",469,46,313,42,156,46
1500000US530330038002,530330038002,"Block Group 2, Census Tract 38, King County, Washington",378,44,301,38,77,37
1500000US530330039001,530330039001,"Block Group 1, Census Tract 39, King County, Washington",773,68,526,70,247,73
1500000US530330039002,530330039002,"Block Group 2, Census Tract 39, King County, Washington",401,40,367,44,34,23
1500000US530330040001,530330040001,"Block Group 1, Census Tract 40, King County, Washington",1007,80,523,65,484,76
1500000US530330040002,530330040002,"Block Group 2, Census Tract 40, King County, Washington",342,44,333,47,9,14
1500000US530330041001,530330041001,"Block Group 1, Census Tract 41, King County, Washington",607,102,247,66,360,94
1500000US530330041002,530330041002,"Block Group 2, Census Tract 41, King County, Washington",617,104,548,110,69,58
1500000US530330041003,530330041003,"Block Group 3, Census Tract 41, King County, Washington",435,81,412,85,23,28
1500000US530330041004,530330041004,"Block Group 4, Census Tract 41, King County, Washington",566,117,327,105,239,98
1500000US530330041005,530330041005,"Block Group 5, Census Tract 41, King County, Washington",394,86,191,60,203,82
1500000US530330041006,530330041006,"Block Group 6, Census Tract 41, King County, Washington",300,74,221,65,79,75
1500000US530330042001,530330042001,"Block Group 1, Census Tract 42, King County, Washington",739,115,602,117,137,58
1500000US530330042002,530330042002,"Block Group 2, Census Tract 42, King County, Washington",699,92,475,84,224,94
1500000US530330042003,530330042003,"Block Group 3, Census Tract 42, King County, Washington",771,97,517,94,254,97
1500000US530330042004,530330042004,"Block Group 4, Census Tract 42, King County, Washington",550,82,431,85,119,65
1500000US530330042005,530330042005,"Block Group 5, Census Tract 42, King County, Washington",558,87,505,96,53,43
1500000US530330043011,530330043011,"Block Group 1, Census Tract 43.01, King County, Washington",484,65,93,34,391,74
1500000US530330043012,530330043012,"Block Group 2, Census Tract 43.01, King County, Washington",455,69,338,58,117,75
1500000US530330043013,530330043013,"Block Group 3, Census Tract 43.01, King County, Washington",479,49,279,45,200,54
1500000US530330043021,530330043021,"Block Group 1, Census Tract 43.02, King County, Washington",619,104,123,62,496,116
1500000US530330043022,530330043022,"Block Group 2, Census Tract 43.02, King County, Washington",900,119,7,10,893,120
1500000US530330044001,530330044001,"Block Group 1, Census Tract 44, King County, Washington",394,83,184,75,210,89
1500000US530330044002,530330044002,"Block Group 2, Census Tract 44, King County, Washington",850,126,268,95,582,142
1500000US530330044003,530330044003,"Block Group 3, Census Tract 44, King County, Washington",493,101,94,64,399,128
1500000US530330044004,530330044004,"Block Group 4, Census Tract 44, King County, Washington",771,146,105,93,666,129
1500000US530330045001,530330045001,"Block Group 1, Census Tract 45, King County, Washington",330,58,197,51,133,51
1500000US530330045002,530330045002,"Block Group 2, Census Tract 45, King County, Washington",674,59,433,61,241,64
1500000US530330046001,530330046001,"Block Group 1, Census Tract 46, King County, Washington",484,76,241,51,243,86
1500000US530330046002,530330046002,"Block Group 2, Census Tract 46, King County, Washington",620,64,405,70,215,66
1500000US530330046003,530330046003,"Block Group 3, Census Tract 46, King County, Washington",337,49,213,38,124,47
1500000US530330047001,530330047001,"Block Group 1, Census Tract 47, King County, Washington",658,198,207,109,451,186
1500000US530330047002,530330047002,"Block Group 2, Census Tract 47, King County, Washington",956,180,317,122,639,178
1500000US530330047003,530330047003,"Block Group 3, Census Tract 47, King County, Washington",1783,228,482,152,1301,202
1500000US530330047004,530330047004,"Block Group 4, Census Tract 47, King County, Washington",1701,243,278,131,1423,268
1500000US530330048001,530330048001,"Block Group 1, Census Tract 48, King County, Washington",526,100,350,94,176,91
1500000US530330048002,530330048002,"Block Group 2, Census Tract 48, King County, Washington",643,89,389,83,254,102
1500000US530330048003,530330048003,"Block Group 3, Census Tract 48, King County, Washington",497,95,187,68,310,98
1500000US530330048004,530330048004,"Block Group 4, Census Tract 48, King County, Washington",515,89,300,83,215,101
1500000US530330049001,530330049001,"Block Group 1, Census Tract 49, King County, Washington",553,110,129,64,424,119
1500000US530330049002,530330049002,"Block Group 2, Census Tract 49, King County, Washington",810,115,46,46,764,124
1500000US530330049003,530330049003,"Block Group 3, Census Tract 49, King County, Washington",686,104,163,67,523,112
1500000US530330049004,530330049004,"Block Group 4, Census Tract 49, King County, Washington",721,110,258,98,463,104
1500000US530330049005,530330049005,"Block Group 5, Census Tract 49, King County, Washington",842,142,108,58,734,153
1500000US530330050001,530330050001,"Block Group 1, Census Tract 50, King County, Washington",690,113,224,70,466,106
1500000US530330050002,530330050002,"Block Group 2, Census Tract 50, King County, Washington",442,67,172,53,270,65
1500000US530330050003,530330050003,"Block Group 3, Census Tract 50, King County, Washington",848,123,65,44,783,126
1500000US530330051001,530330051001,"Block Group 1, Census Tract 51, King County, Washington",639,68,327,58,312,70
1500000US530330051002,530330051002,"Block Group 2, Census Tract 51, King County, Washington",496,51,426,56,70,45
1500000US530330051003,530330051003,"Block Group 3, Census Tract 51, King County, Washington",485,58,296,57,189,54
1500000US530330052001,530330052001,"Block Group 1, Census Tract 52, King County, Washington",404,132,0,12,404,132
1500000US530330052002,530330052002,"Block Group 2, Census Tract 52, King County, Washington",789,147,17,26,772,149
1500000US530330052003,530330052003,"Block Group 3, Census Tract 52, King County, Washington",528,103,142,68,386,120
1500000US530330052004,530330052004,"Block Group 4, Census Tract 52, King County, Washington",571,117,251,77,320,120
1500000US530330052005,530330052005,"Block Group 5, Census Tract 52, King County, Washington",648,143,164,84,484,117
1500000US530330053011,530330053011,"Block Group 1, Census Tract 53.01, King County, Washington",289,100,26,30,263,98
1500000US530330053012,530330053012,"Block Group 2, Census Tract 53.01, King County, Washington",1157,162,37,21,1120,161
1500000US530330053013,530330053013,"Block Group 3, Census Tract 53.01, King County, Washington",547,101,11,18,536,103
1500000US530330053014,530330053014,"Block Group 4, Census Tract 53.01, King County, Washington",815,149,0,12,815,149
1500000US530330053021,530330053021,"Block Group 1, Census Tract 53.02, King County, Washington",116,27,0,12,116,27
1500000US530330053022,530330053022,"Block Group 2, Census Tract 53.02, King County, Washington",17,16,4,6,13,17
1500000US530330053023,530330053023,"Block Group 3, Census Tract 53.02, King County, Washington",0,12,0,12,0,12
1500000US530330054001,530330054001,"Block Group 1, Census Tract 54, King County, Washington",457,93,309,101,148,62
1500000US530330054002,530330054002,"Block Group 2, Census Tract 54, King County, Washington",687,127,424,113,263,108
1500000US530330054003,530330054003,"Block Group 3, Census Tract 54, King County, Washington",721,127,290,86,431,134
1500000US530330054004,530330054004,"Block Group 4, Census Tract 54, King County, Washington",1019,122,286,85,733,142
1500000US530330056001,530330056001,"Block Group 1, Census Tract 56, King County, Washington",555,75,539,78,16,26
1500000US530330056002,530330056002,"Block Group 2, Census Tract 56, King County, Washington",567,96,507,93,60,73
1500000US530330056003,530330056003,"Block Group 3, Census Tract 56, King County, Washington",435,84,386,90,49,47
1500000US530330056004,530330056004,"Block Group 4, Census Tract 56, King County, Washington",478,82,445,83,33,35
1500000US530330056005,530330056005,"Block Group 5, Census Tract 56, King County, Washington",582,103,571,102,11,20
1500000US530330057001,530330057001,"Block Group 1, Census Tract 57, King County, Washington",189,80,128,41,61,78
1500000US530330057002,530330057002,"Block Group 2, Census Tract 57, King County, Washington",472,77,427,83,45,40
1500000US530330057003,530330057003,"Block Group 3, Census Tract 57, King County, Washington",425,88,326,80,99,89
1500000US530330057004,530330057004,"Block Group 4, Census Tract 57, King County, Washington",433,104,336,105,97,63
1500000US530330057005,530330057005,"Block Group 5, Census Tract 57, King County, Washington",478,100,241,98,237,91
1500000US530330057006,530330057006,"Block Group 6, Census Tract 57, King County, Washington",752,110,462,111,290,101
1500000US530330058011,530330058011,"Block Group 1, Census Tract 58.01, King County, Washington",566,106,223,71,343,126
1500000US530330058012,530330058012,"Block Group 2, Census Tract 58.01, King County, Washington",797,115,218,62,579,107
1500000US530330058013,530330058013,"Block Group 3, Census Tract 58.01, King County, Washington",654,89,310,70,344,97
1500000US530330058014,530330058014,"Block Group 4, Census Tract 58.01, King County, Washington",677,127,264,100,413,119
1500000US530330058021,530330058021,"Block Group 1, Census Tract 58.02, King County, Washington",697,133,409,119,288,129
1500000US530330058022,530330058022,"Block Group 2, Census Tract 58.02, King County, Washington",1247,170,329,127,918,154
1500000US530330058023,530330058023,"Block Group 3, Census Tract 58.02, King County, Washington",857,140,289,111,568,143
1500000US530330059001,530330059001,"Block Group 1, Census Tract 59, King County, Washington",840,155,383,134,457,138
1500000US530330059002,530330059002,"Block Group 2, Census Tract 59, King County, Washington",591,133,362,123,229,130
1500000US530330059003,530330059003,"Block Group 3, Census Tract 59, King County, Washington",212,106,114,103,98,82
1500000US530330059004,530330059004,"Block Group 4, Census Tract 59, King County, Washington",614,118,446,108,168,83
1500000US530330059005,530330059005,"Block Group 5, Census Tract 59, King County, Washington",452,112,306,103,146,82
1500000US530330060001,530330060001,"Block Group 1, Census Tract 60, King County, Washington",837,133,277,102,560,115
1500000US530330060002,530330060002,"Block Group 2, Census Tract 60, King County, Washington",590,114,442,108,148,76
1500000US530330060003,530330060003,"Block Group 3, Census Tract 60, King County, Washington",460,118,405,118,55,46
1500000US530330060004,530330060004,"Block Group 4, Census Tract 60, King County, Washington",623,98,195,77,428,106
1500000US530330061001,530330061001,"Block Group 1, Census Tract 61, King County, Washington",575,94,331,95,244,87
1500000US530330061002,530330061002,"Block Group 2, Census Tract 61, King County, Washington",543,104,361,85,182,77
1500000US530330061003,530330061003,"Block Group 3, Census Tract 61, King County, Washington",861,121,218,86,643,121
1500000US530330061004,530330061004,"Block Group 4, Census Tract 61, King County, Washington",943,141,263,95,680,148
1500000US530330062001,530330062001,"Block Group 1, Census Tract 62, King County, Washington",568,53,398,62,170,50
1500000US530330062002,530330062002,"Block Group 2, Census Tract 62, King County, Washington",628,53,585,62,43,31
1500000US530330062003,530330062003,"Block Group 3, Census Tract 62, King County, Washington",419,41,357,45,62,30
1500000US530330063001,530330063001,"Block Group 1, Census Tract 63, King County, Washington",800,149,258,93,542,147
1500000US530330063002,530330063002,"Block Group 2, Census Tract 63, King County, Washington",650,108,464,97,186,105
1500000US530330063003,530330063003,"Block Group 3, Census Tract 63, King County, Washington",585,110,432,78,153,97
1500000US530330063004,530330063004,"Block Group 4, Census Tract 63, King County, Washington",479,71,443,78,36,42
1500000US530330064001,530330064001,"Block Group 1, Census Tract 64, King County, Washington",471,65,372,71,99,57
1500000US530330064002,530330064002,"Block Group 2, Census Tract 64, King County, Washington",381,51,300,54,81,31
1500000US530330064003,530330064003,"Block Group 3, Census Tract 64, King County, Washington",492,74,347,52,145,73
1500000US530330065001,530330065001,"Block Group 1, Census Tract 65, King County, Washington",503,106,396,97,107,69
1500000US530330065002,530330065002,"Block Group 2, Census Tract 65, King County, Washington",1125,160,406,127,719,157
1500000US530330065003,530330065003,"Block Group 3, Census Tract 65, King County, Washington",780,132,251,72,529,130
1500000US530330066001,530330066001,"Block Group 1, Census Tract 66, King County, Washington",1075,166,192,73,883,166
1500000US530330066002,530330066002,"Block Group 2, Census Tract 66, King County, Washington",1083,143,351,84,732,149
1500000US530330067001,530330067001,"Block Group 1, Census Tract 67, King County, Washington",1355,203,312,121,1043,216
1500000US530330067002,530330067002,"Block Group 2, Census Tract 67, King County, Washington",1248,181,327,143,921,201
1500000US530330067003,530330067003,"Block Group 3, Census Tract 67, King County, Washington",876,194,245,113,631,170
1500000US530330067004,530330067004,"Block Group 4, Census Tract 67, King County, Washington",991,176,543,120,448,167
1500000US530330068001,530330068001,"Block Group 1, Census Tract 68, King County, Washington",583,80,322,50,261,83
1500000US530330068002,530330068002,"Block Group 2, Census Tract 68, King County, Washington",834,78,336,54,498,87
1500000US530330069001,530330069001,"Block Group 1, Census Tract 69, King County, Washington",473,88,262,85,211,87
1500000US530330069002,530330069002,"Block Group 2, Census Tract 69, King County, Washington",528,80,393,77,135,58
1500000US530330069003,530330069003,"Block Group 3, Census Tract 69, King County, Washington",485,98,250,73,235,79
1500000US530330069004,530330069004,"Block Group 4, Census Tract 69, King County, Washington",729,107,313,99,416,118
1500000US530330070001,530330070001,"Block Group 1, Census Tract 70, King County, Washington",609,155,316,118,293,134
1500000US530330070002,530330070002,"Block Group 2, Census Tract 70, King County, Washington",984,212,315,175,669,194
1500000US530330070003,530330070003,"Block Group 3, Census Tract 70, King County, Washington",1160,212,200,107,960,228
1500000US530330070004,530330070004,"Block Group 4, Census Tract 70, King County, Washington",706,130,231,100,475,119
1500000US530330070005,530330070005,"Block Group 5, Census Tract 70, King County, Washington",729,172,70,46,659,169
1500000US530330070006,530330070006,"Block Group 6, Census Tract 70, King County, Washington",807,130,330,120,477,120
1500000US530330071001,530330071001,"Block Group 1, Census Tract 71, King County, Washington",1067,146,197,70,870,157
1500000US530330071002,530330071002,"Block Group 2, Census Tract 71, King County, Washington",1619,178,312,103,1307,188
1500000US530330072001,530330072001,"Block Group 1, Census Tract 72, King County, Washington",2967,300,538,173,2429,318
1500000US530330072002,530330072002,"Block Group 2, Census Tract 72, King County, Washington",1039,189,30,48,1009,195
1500000US530330072003,530330072003,"Block Group 3, Census Tract 72, King County, Washington",1407,244,116,86,1291,250
1500000US530330073001,530330073001,"Block Group 1, Census Tract 73, King County, Washington",1651,220,0,12,1651,220
1500000US530330073002,530330073002,"Block Group 2, Census Tract 73, King County, Washington",1263,180,155,71,1108,171
1500000US530330073003,530330073003,"Block Group 3, Census Tract 73, King County, Washington",1085,200,285,118,800,191
1500000US530330074011,530330074011,"Block Group 1, Census Tract 74.01, King County, Washington",810,121,154,79,656,109
1500000US530330074012,530330074012,"Block Group 2, Census Tract 74.01, King County, Washington",953,147,133,70,820,149
1500000US530330074013,530330074013,"Block Group 3, Census Tract 74.01, King County, Washington",877,143,281,76,596,115
1500000US530330074014,530330074014,"Block Group 4, Census Tract 74.01, King County, Washington",919,143,242,97,677,164
1500000US530330074021,530330074021,"Block Group 1, Census Tract 74.02, King County, Washington",1330,169,450,158,880,158
1500000US530330074022,530330074022,"Block Group 2, Census Tract 74.02, King County, Washington",1041,199,140,68,901,210
1500000US530330074023,530330074023,"Block Group 3, Census Tract 74.02, King County, Washington",1143,164,130,65,1013,158
1500000US530330075001,530330075001,"Block Group 1, Census Tract 75, King County, Washington",1025,193,242,147,783,229
1500000US530330075002,530330075002,"Block Group 2, Census Tract 75, King County, Washington",887,178,197,89,690,167
1500000US530330075003,530330075003,"Block Group 3, Census Tract 75, King County, Washington",1075,197,115,95,960,217
1500000US530330075004,530330075004,"Block Group 4, Census Tract 75, King County, Washington",1471,228,225,150,1246,288
1500000US530330075005,530330075005,"Block Group 5, Census Tract 75, King County, Washington",778,179,170,85,608,178
1500000US530330076001,530330076001,"Block Group 1, Census Tract 76, King County, Washington",610,108,249,83,361,96
1500000US530330076002,530330076002,"Block Group 2, Census Tract 76, King County, Washington",781,108,256,89,525,115
1500000US530330076003,530330076003,"Block Group 3, Census Tract 76, King County, Washington",688,109,162,63,526,107
1500000US530330077001,530330077001,"Block Group 1, Census Tract 77, King County, Washington",551,92,302,82,249,88
1500000US530330077002,530330077002,"Block Group 2, Census Tract 77, King County, Washington",412,66,394,60,18,28
1500000US530330077003,530330077003,"Block Group 3, Census Tract 77, King County, Washington",361,79,266,90,95,63
1500000US530330077004,530330077004,"Block Group 4, Census Tract 77, King County, Washington",973,128,312,92,661,141
1500000US530330078001,530330078001,"Block Group 1, Census Tract 78, King County, Washington",580,123,436,91,144,99
1500000US530330078002,530330078002,"Block Group 2, Census Tract 78, King County, Washington",596,97,481,94,115,94
1500000US530330078003,530330078003,"Block Group 3, Census Tract 78, King County, Washington",590,87,355,86,235,107
1500000US530330078004,530330078004,"Block Group 4, Census Tract 78, King County, Washington",466,88,369,90,97,60
1500000US530330079001,530330079001,"Block Group 1, Census Tract 79, King County, Washington",415,119,255,110,160,68
1500000US530330079002,530330079002,"Block Group 2, Census Tract 79, King County, Washington",431,98,65,48,366,102
1500000US530330079003,530330079003,"Block Group 3, Census Tract 79, King County, Washington",440,104,182,57,258,100
1500000US530330079004,530330079004,"Block Group 4, Census Tract 79, King County, Washington",873,116,178,65,695,117
1500000US530330079005,530330079005,"Block Group 5, Census Tract 79, King County, Washington",956,139,249,90,707,154
1500000US530330080011,530330080011,"Block Group 1, Census Tract 80.01, King County, Washington",1014,249,408,142,606,254
1500000US530330080012,530330080012,"Block Group 2, Census Tract 80.01, King County, Washington",755,211,64,48,691,210
1500000US530330080013,530330080013,"Block Group 3, Census Tract 80.01, King County, Washington",883,181,178,146,705,167
1500000US530330080014,530330080014,"Block Group 4, Census Tract 80.01, King County, Washington",1000,226,271,121,729,232
1500000US530330080015,530330080015,"Block Group 5, Census Tract 80.01, King County, Washington",712,251,16,25,696,252
1500000US530330080021,530330080021,"Block Group 1, Census Tract 80.02, King County, Washington",1291,154,337,96,954,153
1500000US530330080022,530330080022,"Block Group 2, Census Tract 80.02, King County, Washington",1052,151,157,77,895,137
1500000US530330081001,530330081001,"Block Group 1, Census Tract 81, King County, Washington",1295,191,243,113,1052,155
1500000US530330081002,530330081002,"Block Group 2, Census Tract 81, King County, Washington",484,133,111,56,373,126
1500000US530330081003,530330081003,"Block Group 3, Census Tract 81, King County, Washington",800,135,271,76,529,127
1500000US530330082001,530330082001,"Block Group 1, Census Tract 82, King County, Washington",978,148,130,58,848,157
1500000US530330082002,530330082002,"Block Group 2, Census Tract 82, King County, Washington",926,162,62,42,864,164
1500000US530330082003,530330082003,"Block Group 3, Census Tract 82, King County, Washington",780,117,229,82,551,121
1500000US530330083001,530330083001,"Block Group 1, Census Tract 83, King County, Washington",938,92,332,66,606,89
1500000US530330083002,530330083002,"Block Group 2, Census Tract 83, King County, Washington",1147,95,251,50,896,108
1500000US530330084001,530330084001,"Block Group 1, Census Tract 84, King County, Washington",1005,153,88,48,917,149
1500000US530330084002,530330084002,"Block Group 2, Census Tract 84, King County, Washington",1107,138,109,52,998,137
1500000US530330084003,530330084003,"Block Group 3, Census Tract 84, King County, Washington",928,150,121,67,807,157
1500000US530330085001,530330085001,"Block Group 1, Census Tract 85, King County, Washington",924,91,130,56,794,89
1500000US530330085002,530330085002,"Block Group 2, Census Tract 85, King County, Washington",559,96,61,54,498,88
1500000US530330085003,530330085003,"Block Group 3, Census Tract 85, King County, Washington",405,80,0,12,405,80
1500000US530330086001,530330086001,"Block Group 1, Census Tract 86, King County, Washington",762,115,159,76,603,126
1500000US530330086002,530330086002,"Block Group 2, Census Tract 86, King County, Washington",705,110,167,71,538,112
1500000US530330086003,530330086003,"Block Group 3, Census Tract 86, King County, Washington",503,92,72,42,431,89
1500000US530330087001,530330087001,"Block Group 1, Census Tract 87, King County, Washington",656,110,241,66,415,96
1500000US530330087002,530330087002,"Block Group 2, Census Tract 87, King County, Washington",483,106,111,49,372,99
1500000US530330087003,530330087003,"Block Group 3, Census Tract 87, King County, Washington",658,90,241,68,417,107
1500000US530330088001,530330088001,"Block Group 1, Census Tract 88, King County, Washington",630,78,402,84,228,84
1500000US530330088002,530330088002,"Block Group 2, Census Tract 88, King County, Washington",497,67,299,60,198,61
1500000US530330088003,530330088003,"Block Group 3, Census Tract 88, King County, Washington",443,87,144,41,299,85
1500000US530330089001,530330089001,"Block Group 1, Census Tract 89, King County, Washington",612,153,261,87,351,150
1500000US530330089002,530330089002,"Block Group 2, Census Tract 89, King County, Washington",588,116,320,114,268,137
1500000US530330089003,530330089003,"Block Group 3, Census Tract 89, King County, Washington",567,142,214,93,353,159
1500000US530330089004,530330089004,"Block Group 4, Census Tract 89, King County, Washington",460,130,176,84,284,125
1500000US530330090001,530330090001,"Block Group 1, Census Tract 90, King County, Washington",723,92,275,66,448,85
1500000US530330090002,530330090002,"Block Group 2, Census Tract 90, King County, Washington",1024,85,184,48,840,90
1500000US530330091001,530330091001,"Block Group 1, Census Tract 91, King County, Washington",482,87,25,20,457,86
1500000US530330091002,530330091002,"Block Group 2, Census Tract 91, King County, Washington",1011,108,74,35,937,106
1500000US530330092001,530330092001,"Block Group 1, Census Tract 92, King County, Washington",938,109,35,26,903,107
1500000US530330092002,530330092002,"Block Group 2, Census Tract 92, King County, Washington",790,103,35,34,755,104
1500000US530330093001,530330093001,"Block Group 1, Census Tract 93, King County, Washington",476,63,185,47,291,61
1500000US530330093002,530330093002,"Block Group 2, Census Tract 93, King County, Washington",192,38,107,28,85,32
1500000US530330093003,530330093003,"Block Group 3, Census Tract 93, King County, Washington",439,64,254,52,185,60
1500000US530330094001,530330094001,"Block Group 1, Census Tract 94, King County, Washington",623,133,93,51,530,136
1500000US530330094002,530330094002,"Block Group 2, Census Tract 94, King County, Washington",687,134,314,110,373,122
1500000US530330094003,530330094003,"Block Group 3, Census Tract 94, King County, Washington",409,109,301,91,108,79
1500000US530330094004,530330094004,"Block Group 4, Census Tract 94, King County, Washington",311,104,131,51,180,92
1500000US530330094005,530330094005,"Block Group 5, Census Tract 94, King County, Washington",497,131,155,72,342,113
1500000US530330095001,530330095001,"Block Group 1, Census Tract 95, King County, Washington",758,119,649,119,109,94
1500000US530330095002,530330095002,"Block Group 2, Census Tract 95, King County, Washington",838,159,550,139,288,103
1500000US530330095003,530330095003,"Block Group 3, Census Tract 95, King County, Washington",450,83,438,86,12,18
1500000US530330095004,530330095004,"Block Group 4, Census Tract 95, King County, Washington",578,158,260,68,318,143
1500000US530330096001,530330096001,"Block Group 1, Census Tract 96, King County, Washington",269,59,218,58,51,47
1500000US530330096002,530330096002,"Block Group 2, Census Tract 96, King County, Washington",718,132,214,81,504,150
1500000US530330096003,530330096003,"Block Group 3, Census Tract 96, King County, Washington",573,126,307,80,266,113
1500000US530330096004,530330096004,"Block Group 4, Census Tract 96, King County, Washington",470,94,195,77,275,92
1500000US530330096005,530330096005,"Block Group 5, Census Tract 96, King County, Washington",710,102,477,112,233,109
1500000US530330097011,530330097011,"Block Group 1, Census Tract 97.01, King County, Washington",937,166,420,117,517,165
1500000US530330097012,530330097012,"Block Group 2, Census Tract 97.01, King County, Washington",520,111,169,75,351,104
1500000US530330097013,530330097013,"Block Group 3, Census Tract 97.01, King County, Washington",660,127,286,113,374,98
1500000US530330097014,530330097014,"Block Group 4, Census Tract 97.01, King County, Washington",943,140,763,150,180,76
1500000US530330097021,530330097021,"Block Group 1, Census Tract 97.02, King County, Washington",641,80,533,87,108,57
1500000US530330097022,530330097022,"Block Group 2, Census Tract 97.02, King County, Washington",401,72,377,72,24,27
1500000US530330097023,530330097023,"Block Group 3, Census Tract 97.02, King County, Washington",339,64,329,68,10,15
1500000US530330097024,530330097024,"Block Group 4, Census Tract 97.02, King County, Washington",372,72,327,72,45,42
1500000US530330097025,530330097025,"Block Group 5, Census Tract 97.02, King County, Washington",585,89,394,81,191,82
1500000US530330098001,530330098001,"Block Group 1, Census Tract 98, King County, Washington",544,90,296,93,248,72
1500000US530330098002,530330098002,"Block Group 2, Census Tract 98, King County, Washington",554,94,442,89,112,84
1500000US530330098003,530330098003,"Block Group 3, Census Tract 98, King County, Washington",608,75,501,103,107,61
1500000US530330098004,530330098004,"Block Group 4, Census Tract 98, King County, Washington",627,93,494,91,133,60
1500000US530330098005,530330098005,"Block Group 5, Census Tract 98, King County, Washington",713,113,292,92,421,133
1500000US530330099001,530330099001,"Block Group 1, Census Tract 99, King County, Washington",579,109,389,88,190,107
1500000US530330099002,530330099002,"Block Group 2, Census Tract 99, King County, Washington",844,157,576,144,268,128
1500000US530330099003,530330099003,"Block Group 3, Census Tract 99, King County, Washington",898,123,282,106,616,132
1500000US530330099004,530330099004,"Block Group 4, Census Tract 99, King County, Washington",481,82,283,88,198,88
1500000US530330100011,530330100011,"Block Group 1, Census Tract 100.01, King County, Washington",399,86,256,94,143,83
1500000US530330100012,530330100012,"Block Group 2, Census Tract 100.01, King County, Washington",495,89,316,63,179,83
1500000US530330100013,530330100013,"Block Group 3, Census Tract 100.01, King County, Washington",645,99,238,76,407,104
1500000US530330100021,530330100021,"Block Group 1, Census Tract 100.02, King County, Washington",401,100,225,63,176,85
1500000US530330100022,530330100022,"Block Group 2, Census Tract 100.02, King County, Washington",644,92,160,70,484,97
1500000US530330100023,530330100023,"Block Group 3, Census Tract 100.02, King County, Washington",324,53,255,61,69,33
1500000US530330100024,530330100024,"Block Group 4, Census Tract 100.02, King County, Washington",449,84,211,52,238,95
1500000US530330101001,530330101001,"Block Group 1, Census Tract 101, King County, Washington",413,109,318,70,95,109
1500000US530330101002,530330101002,"Block Group 2, Census Tract 101, King County, Washington",360,89,232,66,128,73
1500000US530330101003,530330101003,"Block Group 3, Census Tract 101, King County, Washington",589,147,250,86,339,124
1500000US530330101004,530330101004,"Block Group 4, Census Tract 101, King County, Washington",802,184,271,91,531,183
1500000US530330101005,530330101005,"Block Group 5, Census Tract 101, King County, Washington",776,132,446,93,330,120
1500000US530330102001,530330102001,"Block Group 1, Census Tract 102, King County, Washington",623,64,492,67,131,70
1500000US530330102002,530330102002,"Block Group 2, Census Tract 102, King County, Washington",406,54,351,57,55,33
1500000US530330102003,530330102003,"Block Group 3, Census Tract 102, King County, Washington",385,70,263,58,122,54
1500000US530330102004,530330102004,"Block Group 4, Census Tract 102, King County, Washington",514,62,400,65,114,53
1500000US530330103001,530330103001,"Block Group 1, Census Tract 103, King County, Washington",418,107,287,100,131,62
1500000US530330103002,530330103002,"Block Group 2, Census Tract 103, King County, Washington",534,128,362,125,172,100
1500000US530330103003,530330103003,"Block Group 3, Census Tract 103, King County, Washington",414,131,213,86,201,120
1500000US530330103004,530330103004,"Block Group 4, Census Tract 103, King County, Washington",495,140,237,96,258,103
1500000US530330103005,530330103005,"Block Group 5, Census Tract 103, King County, Washington",737,157,187,89,550,161
1500000US530330104011,530330104011,"Block Group 1, Census Tract 104.01, King County, Washington",469,69,346,65,123,64
1500000US530330104012,530330104012,"Block Group 2, Census Tract 104.01, King County, Washington",589,73,442,76,147,61
1500000US530330104013,530330104013,"Block Group 3, Census Tract 104.01, King County, Washington",359,72,331,67,28,27
1500000US530330104021,530330104021,"Block Group 1, Census Tract 104.02, King County, Washington",376,65,257,69,119,41
1500000US530330104022,530330104022,"Block Group 2, Census Tract 104.02, King County, Washington",448,69,371,72,77,44
1500000US530330104023,530330104023,"Block Group 3, Census Tract 104.02, King County, Washington",333,88,252,86,81,58
1500000US530330104024,530330104024,"Block Group 4, Census Tract 104.02, King County, Washington",504,88,288,70,216,100
1500000US530330105001,530330105001,"Block Group 1, Census Tract 105, King County, Washington",649,156,80,42,569,156
1500000US530330105002,530330105002,"Block Group 2, Census Tract 105, King County, Washington",515,94,308,84,207,79
1500000US530330105003,530330105003,"Block Group 3, Census Tract 105, King County, Washington",457,107,415,106,42,38
1500000US530330105004,530330105004,"Block Group 4, Census Tract 105, King County, Washington",1183,178,177,65,1006,173
1500000US530330105005,530330105005,"Block Group 5, Census Tract 105, King County, Washington",772,112,487,88,285,100
1500000US530330106001,530330106001,"Block Group 1, Census Tract 106, King County, Washington",709,112,605,98,104,63
1500000US530330106002,530330106002,"Block Group 2, Census Tract 106, King County, Washington",520,92,268,75,252,92
1500000US530330106003,530330106003,"Block Group 3, Census Tract 106, King County, Washington",742,120,418,84,324,113
1500000US530330106004,530330106004,"Block Group 4, Census Tract 106, King County, Washington",461,119,254,97,207,92
1500000US530330106005,530330106005,"Block Group 5, Census Tract 106, King County, Washington",747,110,592,92,155,97
1500000US530330106006,530330106006,"Block Group 6, Census Tract 106, King County, Washington",420,72,238,75,182,68
1500000US530330107011,530330107011,"Block Group 1, Census Tract 107.01, King County, Washington",867,94,303,68,564,97
1500000US530330107012,530330107012,"Block Group 2, Census Tract 107.01, King County, Washington",533,80,290,64,243,73
1500000US530330107021,530330107021,"Block Group 1, Census Tract 107.02, King County, Washington",434,85,290,76,144,60
1500000US530330107022,530330107022,"Block Group 2, Census Tract 107.02, King County, Washington",549,97,138,49,411,90
1500000US530330107023,530330107023,"Block Group 3, Census Tract 107.02, King County, Washington",511,111,96,43,415,111
1500000US530330108001,530330108001,"Block Group 1, Census Tract 108, King County, Washington",539,79,374,76,165,59
1500000US530330108002,530330108002,"Block Group 2, Census Tract 108, King County, Washington",491,91,308,74,183,83
1500000US530330108003,530330108003,"Block Group 3, Census Tract 108, King County, Washington",754,83,487,82,267,88
1500000US530330109001,530330109001,"Block Group 1, Census Tract 109, King County, Washington",402,50,162,54,240,64
1500000US530330109002,530330109002,"Block Group 2, Census Tract 109, King County, Washington",208,45,110,37,98,37
1500000US530330110011,530330110011,"Block Group 1, Census Tract 110.01, King County, Washington",377,74,180,48,197,69
1500000US530330110012,530330110012,"Block Group 2, Census Tract 110.01, King County, Washington",506,110,76,30,430,107
1500000US530330110013,530330110013,"Block Group 3, Census Tract 110.01, King County, Washington",756,93,320,90,436,91
1500000US530330110021,530330110021,"Block Group 1, Census Tract 110.02, King County, Washington",260,54,186,52,74,36
1500000US530330110022,530330110022,"Block Group 2, Census Tract 110.02, King County, Washington",657,83,281,69,376,94
1500000US530330110023,530330110023,"Block Group 3, Census Tract 110.02, King County, Washington",362,75,244,64,118,54
1500000US530330111011,530330111011,"Block Group 1, Census Tract 111.01, King County, Washington",391,81,82,41,309,78
1500000US530330111012,530330111012,"Block Group 2, Census Tract 111.01, King County, Washington",625,121,252,82,373,111
1500000US530330111013,530330111013,"Block Group 3, Census Tract 111.01, King County, Washington",350,91,193,58,157,91
1500000US530330111014,530330111014,"Block Group 4, Census Tract 111.01, King County, Washington",422,81,286,74,136,76
1500000US530330111021,530330111021,"Block Group 1, Census Tract 111.02, King County, Washington",420,55,385,58,35,22
1500000US530330111022,530330111022,"Block Group 2, Census Tract 111.02, King County, Washington",363,95,169,54,194,86
1500000US530330111023,530330111023,"Block Group 3, Census Tract 111.02, King County, Washington",371,100,77,46,294,100
1500000US530330111024,530330111024,"Block Group 4, Census Tract 111.02, King County, Washington",307,73,178,48,129,64
1500000US530330112001,530330112001,"Block Group 1, Census Tract 112, King County, Washington",429,82,238,59,191,86
1500000US530330112002,530330112002,"Block Group 2, Census Tract 112, King County, Washington",392,85,200,66,192,74
1500000US530330112003,530330112003,"Block Group 3, Census Tract 112, King County, Washington",591,114,199,65,392,124
1500000US530330113001,530330113001,"Block Group 1, Census Tract 113, King County, Washington",1307,140,237,73,1070,131
1500000US530330113002,530330113002,"Block Group 2, Census Tract 113, King County, Washington",420,84,255,80,165,96
1500000US530330113003,530330113003,"Block Group 3, Census Tract 113, King County, Washington",316,102,212,59,104,92
1500000US530330113004,530330113004,"Block Group 4, Census Tract 113, King County, Washington",433,78,342,84,91,54
1500000US530330113005,530330113005,"Block Group 5, Census Tract 113, King County, Washington",518,109,233,73,285,115
1500000US530330114011,530330114011,"Block Group 1, Census Tract 114.01, King County, Washington",646,117,142,63,504,105
1500000US530330114012,530330114012,"Block Group 2, Census Tract 114.01, King County, Washington",510,94,201,61,309,99
1500000US530330114013,530330114013,"Block Group 3, Census Tract 114.01, King County, Washington",550,63,436,70,114,57
1500000US530330114021,530330114021,"Block Group 1, Census Tract 114.02, King County, Washington",585,71,278,50,307,78
1500000US530330114022,530330114022,"Block Group 2, Census Tract 114.02, King County, Washington",612,102,254,69,358,104
1500000US530330114023,530330114023,"Block Group 3, Census Tract 114.02, King County, Washington",748,91,308,63,440,93
1500000US530330115001,530330115001,"Block Group 1, Census Tract 115, King County, Washington",534,66,484,66,50,29
1500000US530330115002,530330115002,"Block Group 2, Census Tract 115, King County, Washington",675,69,477,81,198,75
1500000US530330115003,530330115003,"Block Group 3, Census Tract 115, King County, Washington",767,75,437,68,330,82
1500000US530330116001,530330116001,"Block Group 1, Census Tract 116, King County, Washington",636,118,442,95,194,116
1500000US530330116002,530330116002,"Block Group 2, Census Tract 116, King County, Washington",558,112,426,102,132,93
1500000US530330116003,530330116003,"Block Group 3, Census Tract 116, King County, Washington",557,90,503,90,54,48
1500000US530330116004,530330116004,"Block Group 4, Census Tract 116, King County, Washington",364,67,248,61,116,63
1500000US530330116005,530330116005,"Block Group 5, Census Tract 116, King County, Washington",458,78,310,72,148,70
1500000US530330116006,530330116006,"Block Group 6, Census Tract 116, King County, Washington",522,114,291,105,231,88
1500000US530330117001,530330117001,"Block Group 1, Census Tract 117, King County, Washington",421,108,189,60,232,99
1500000US530330117002,530330117002,"Block Group 2, Census Tract 117, King County, Washington",476,85,370,89,106,73
1500000US530330117003,530330117003,"Block Group 3, Census Tract 117, King County, Washington",494,87,410,94,84,60
1500000US530330117004,530330117004,"Block Group 4, Census Tract 117, King County, Washington",318,92,278,87,40,55
1500000US530330118001,530330118001,"Block Group 1, Census Tract 118, King County, Washington",357,113,272,91,85,82
1500000US530330118002,530330118002,"Block Group 2, Census Tract 118, King County, Washington",281,92,235,85,46,43
1500000US530330118003,530330118003,"Block Group 3, Census Tract 118, King County, Washington",290,120,202,105,88,71
1500000US530330118004,530330118004,"Block Group 4, Census Tract 118, King County, Washington",583,154,154,58,429,146
1500000US530330118005,530330118005,"Block Group 5, Census Tract 118, King County, Washington",504,93,374,95,130,58
1500000US530330118006,530330118006,"Block Group 6, Census Tract 118, King County, Washington",757,162,85,57,672,159
1500000US530330119001,530330119001,"Block Group 1, Census Tract 119, King County, Washington",688,131,547,131,141,80
1500000US530330119002,530330119002,"Block Group 2, Census Tract 119, King County, Washington",486,97,393,80,93,74
1500000US530330119003,530330119003,"Block Group 3, Census Tract 119, King County, Washington",403,140,193,78,210,125
1500000US530330119004,530330119004,"Block Group 4, Census Tract 119, King County, Washington",563,125,319,133,244,128
1500000US530330119005,530330119005,"Block Group 5, Census Tract 119, King County, Washington",460,89,290,78,170,113
1500000US530330120001,530330120001,"Block Group 1, Census Tract 120, King County, Washington",547,82,429,83,118,69
1500000US530330120002,530330120002,"Block Group 2, Census Tract 120, King County, Washington",417,64,359,58,58,52
1500000US530330120003,530330120003,"Block Group 3, Census Tract 120, King County, Washington",526,70,437,75,89,55
1500000US530330121001,530330121001,"Block Group 1, Census Tract 121, King County, Washington",462,54,388,58,74,39
1500000US530330121002,530330121002,"Block Group 2, Census Tract 121, King County, Washington",740,63,669,74,71,53
1500000US530330201001,530330201001,"Block Group 1, Census Tract 201, King County, Washington",488,52,465,56,23,21
1500000US530330201002,530330201002,"Block Group 2, Census Tract 201, King County, Washington",367,47,291,55,76,51
1500000US530330201003,530330201003,"Block Group 3, Census Tract 201, King County, Washington",407,45,355,49,52,45
1500000US530330202001,530330202001,"Block Group 1, Census Tract 202, King County, Washington",384,86,330,75,54,49
1500000US530330202002,530330202002,"Block Group 2, Census Tract 202, King County, Washington",527,97,255,99,272,79
1500000US530330202003,530330202003,"Block Group 3, Census Tract 202, King County, Washington",347,71,229,69,118,65
1500000US530330202004,530330202004,"Block Group 4, Census Tract 202, King County, Washington",421,88,410,90,11,18
1500000US530330202005,530330202005,"Block Group 5, Census Tract 202, King County, Washington",443,91,307,79,136,96
1500000US530330203001,530330203001,"Block Group 1, Census Tract 203, King County, Washington",705,139,127,69,578,127
1500000US530330203002,530330203002,"Block Group 2, Census Tract 203, King County, Washington",390,97,342,101,48,40
1500000US530330203003,530330203003,"Block Group 3, Census Tract 203, King County, Washington",355,82,178,79,177,66
1500000US530330203004,530330203004,"Block Group 4, Census Tract 203, King County, Washington",490,103,281,94,209,80
1500000US530330203005,530330203005,"Block Group 5, Census Tract 203, King County, Washington",1098,170,283,127,815,171
1500000US530330204011,530330204011,"Block Group 1, Census Tract 204.01, King County, Washington",815,76,343,69,472,93
1500000US530330204012,530330204012,"Block Group 2, Census Tract 204.01, King County, Washington",346,61,327,63,19,20
1500000US530330204013,530330204013,"Block Group 3, Census Tract 204.01, King County, Washington",245,47,209,45,36,30
1500000US530330204021,530330204021,"Block Group 1, Census Tract 204.02, King County, Washington",526,90,379,73,147,70
1500000US530330204022,530330204022,"Block Group 2, Census Tract 204.02, King County, Washington",423,80,303,71,120,84
1500000US530330204023,530330204023,"Block Group 3, Census Tract 204.02, King County, Washington",299,96,189,41,110,91
1500000US530330204024,530330204024,"Block Group 4, Census Tract 204.02, King County, Washington",358,61,320,59,38,35
1500000US530330204025,530330204025,"Block Group 5, Census Tract 204.02, King County, Washington",569,124,339,103,230,104
1500000US530330205001,530330205001,"Block Group 1, Census Tract 205, King County, Washington",756,123,424,101,332,123
1500000US530330205002,530330205002,"Block Group 2, Census Tract 205, King County, Washington",544,121,309,118,235,94
1500000US530330205003,530330205003,"Block Group 3, Census Tract 205, King County, Washington",422,93,259,95,163,77
1500000US530330205004,530330205004,"Block Group 4, Census Tract 205, King County, Washington",271,66,216,61,55,44
1500000US530330205005,530330205005,"Block Group 5, Census Tract 205, King County, Washington",393,97,202,70,191,93
1500000US530330205006,530330205006,"Block Group 6, Census Tract 205, King County, Washington",318,76,258,70,60,53
1500000US530330206001,530330206001,"Block Group 1, Census Tract 206, King County, Washington",303,49,248,57,55,33
1500000US530330206002,530330206002,"Block Group 2, Census Tract 206, King County, Washington",327,76,231,64,96,46
1500000US530330206003,530330206003,"Block Group 3, Census Tract 206, King County, Washington",315,53,214,54,101,57
1500000US530330206004,530330206004,"Block Group 4, Census Tract 206, King County, Washington",355,65,321,70,34,29
1500000US530330207001,530330207001,"Block Group 1, Census Tract 207, King County, Washington",477,71,178,53,299,64
1500000US530330207002,530330207002,"Block Group 2, Census Tract 207, King County, Washington",569,84,187,48,382,92
1500000US530330207003,530330207003,"Block Group 3, Census Tract 207, King County, Washington",458,83,381,76,77,64
1500000US530330208001,530330208001,"Block Group 1, Census Tract 208, King County, Washington",585,84,218,46,367,94
1500000US530330208002,530330208002,"Block Group 2, Census Tract 208, King County, Washington",526,74,499,80,27,24
1500000US530330208003,530330208003,"Block Group 3, Census Tract 208, King County, Washington",329,39,303,44,26,21
1500000US530330208004,530330208004,"Block Group 4, Census Tract 208, King County, Washington",332,47,323,48,9,14
1500000US530330209001,530330209001,"Block Group 1, Census Tract 209, King County, Washington",662,79,453,80,209,77
1500000US530330209002,530330209002,"Block Group 2, Census Tract 209, King County, Washington",429,60,276,56,153,50
1500000US530330209003,530330209003,"Block Group 3, Census Tract 209, King County, Washington",337,67,270,63,67,50
1500000US530330210001,530330210001,"Block Group 1, Census Tract 210, King County, Washington",330,66,320,67,10,21
1500000US530330210002,530330210002,"Block Group 2, Census Tract 210, King County, Washington",323,85,237,71,86,66
1500000US530330210003,530330210003,"Block Group 3, Census Tract 210, King County, Washington",602,122,339,113,263,118
1500000US530330210004,530330210004,"Block Group 4, Census Tract 210, King County, Washington",461,108,359,103,102,87
1500000US530330210005,530330210005,"Block Group 5, Census Tract 210, King County, Washington",404,101,283,116,121,72
1500000US530330211001,530330211001,"Block Group 1, Census Tract 211, King County, Washington",590,73,440,79,150,83
1500000US530330211002,530330211002,"Block Group 2, Census Tract 211, King County, Washington",499,74,277,69,222,73
1500000US530330211003,530330211003,"Block Group 3, Census Tract 211, King County, Washington",468,82,153,58,315,82
1500000US530330211004,530330211004,"Block Group 4, Census Tract 211, King County, Washington",0,12,0,12,0,12
1500000US530330213001,530330213001,"Block Group 1, Census Tract 213, King County, Washington",716,97,386,69,330,90
1500000US530330213002,530330213002,"Block Group 2, Census Tract 213, King County, Washington",514,96,297,94,217,94
1500000US530330213003,530330213003,"Block Group 3, Census Tract 213, King County, Washington",518,77,315,64,203,72
1500000US530330214001,530330214001,"Block Group 1, Census Tract 214, King County, Washington",330,49,306,48,24,22
1500000US530330214002,530330214002,"Block Group 2, Census Tract 214, King County, Washington",610,72,467,73,143,67
1500000US530330214003,530330214003,"Block Group 3, Census Tract 214, King County, Washington",473,74,382,72,91,45
1500000US530330215001,530330215001,"Block Group 1, Census Tract 215, King County, Washington",338,66,309,72,29,25
1500000US530330215002,530330215002,"Block Group 2, Census Tract 215, King County, Washington",375,58,314,52,61,51
1500000US530330215003,530330215003,"Block Group 3, Census Tract 215, King County, Washington",623,64,592,68,31,27
1500000US530330215004,530330215004,"Block Group 4, Census Tract 215, King County, Washington",410,59,373,55,37,43
1500000US530330216001,530330216001,"Block Group 1, Census Tract 216, King County, Washington",523,65,449,69,74,37
1500000US530330216002,530330216002,"Block Group 2, Census Tract 216, King County, Washington",433,73,331,64,102,52
1500000US530330216003,530330216003,"Block Group 3, Census Tract 216, King County, Washington",493,60,344,53,149,46
1500000US530330216004,530330216004,"Block Group 4, Census Tract 216, King County, Washington",334,59,235,39,99,49
1500000US530330217001,530330217001,"Block Group 1, Census Tract 217, King County, Washington",578,108,143,60,435,104
1500000US530330217002,530330217002,"Block Group 2, Census Tract 217, King County, Washington",702,115,532,91,170,82
1500000US530330217003,530330217003,"Block Group 3, Census Tract 217, King County, Washington",537,85,457,93,80,56
1500000US530330217004,530330217004,"Block Group 4, Census Tract 217, King County, Washington",738,132,239,95,499,116
1500000US530330217005,530330217005,"Block Group 5, Census Tract 217, King County, Washington",893,118,594,106,299,70
1500000US530330218021,530330218021,"Block Group 1, Census Tract 218.02, King County, Washington",836,114,727,115,109,82
1500000US530330218022,530330218022,"Block Group 2, Census Tract 218.02, King County, Washington",918,135,299,101,619,143
1500000US530330218023,530330218023,"Block Group 3, Census Tract 218.02, King County, Washington",501,80,417,91,84,59
1500000US530330218031,530330218031,"Block Group 1, Census Tract 218.03, King County, Washington",638,96,330,58,308,87
1500000US530330218032,530330218032,"Block Group 2, Census Tract 218.03, King County, Washington",327,56,185,46,142,50
1500000US530330218033,530330218033,"Block Group 3, Census Tract 218.03, King County, Washington",610,92,336,70,274,83
1500000US530330218034,530330218034,"Block Group 4, Census Tract 218.03, King County, Washington",399,52,312,49,87,30
1500000US530330218041,530330218041,"Block Group 1, Census Tract 218.04, King County, Washington",577,64,458,52,119,46
1500000US530330218042,530330218042,"Block Group 2, Census Tract 218.04, King County, Washington",703,81,336,70,367,84
1500000US530330218043,530330218043,"Block Group 3, Census Tract 218.04, King County, Washington",434,77,304,59,130,47
1500000US530330219031,530330219031,"Block Group 1, Census Tract 219.03, King County, Washington",953,183,418,137,535,146
1500000US530330219032,530330219032,"Block Group 2, Census Tract 219.03, King County, Washington",401,76,363,85,38,44
1500000US530330219033,530330219033,"Block Group 3, Census Tract 219.03, King County, Washington",259,71,238,68,21,34
1500000US530330219034,530330219034,"Block Group 4, Census Tract 219.03, King County, Washington",186,60,169,63,17,28
1500000US530330219035,530330219035,"Block Group 5, Census Tract 219.03, King County, Washington",605,153,342,72,263,153
1500000US530330219041,530330219041,"Block Group 1, Census Tract 219.04, King County, Washington",595,81,325,66,270,78
1500000US530330219042,530330219042,"Block Group 2, Census Tract 219.04, King County, Washington",297,47,268,49,29,21
1500000US530330219043,530330219043,"Block Group 3, Census Tract 219.04, King County, Washington",520,68,344,64,176,60
1500000US530330219044,530330219044,"Block Group 4, Census Tract 219.04, King County, Washington",377,71,330,58,47,61
1500000US530330219051,530330219051,"Block Group 1, Census Tract 219.05, King County, Washington",800,124,653,132,147,88
1500000US530330219052,530330219052,"Block Group 2, Census Tract 219.05, King County, Washington",428,71,387,74,41,46
1500000US530330219053,530330219053,"Block Group 3, Census Tract 219.05, King County, Washington",567,138,432,157,135,54
1500000US530330219054,530330219054,"Block Group 4, Census Tract 219.05, King County, Washington",415,94,360,96,55,40
1500000US530330219061,530330219061,"Block Group 1, Census Tract 219.06, King County, Washington",681,78,614,77,67,39
1500000US530330219062,530330219062,"Block Group 2, Census Tract 219.06, King County, Washington",261,66,218,49,43,55
1500000US530330219063,530330219063,"Block Group 3, Census Tract 219.06, King County, Washington",626,109,320,72,306,116
1500000US530330220011,530330220011,"Block Group 1, Census Tract 220.01, King County, Washington",431,114,364,106,67,57
1500000US530330220012,530330220012,"Block Group 2, Census Tract 220.01, King County, Washington",1239,129,633,101,606,124
1500000US530330220013,530330220013,"Block Group 3, Census Tract 220.01, King County, Washington",500,84,295,80,205,63
1500000US530330220031,530330220031,"Block Group 1, Census Tract 220.03, King County, Washington",447,62,404,65,43,32
1500000US530330220032,530330220032,"Block Group 2, Census Tract 220.03, King County, Washington",439,78,316,66,123,60
1500000US530330220033,530330220033,"Block Group 3, Census Tract 220.03, King County, Washington",377,65,280,58,97,50
1500000US530330220034,530330220034,"Block Group 4, Census Tract 220.03, King County, Washington",337,80,243,69,94,71
1500000US530330220035,530330220035,"Block Group 5, Census Tract 220.03, King County, Washington",351,71,85,33,266,64
1500000US530330220051,530330220051,"Block Group 1, Census Tract 220.05, King County, Washington",934,126,601,137,333,117
1500000US530330220052,530330220052,"Block Group 2, Census Tract 220.05, King County, Washington",443,106,219,91,224,88
1500000US530330220053,530330220053,"Block Group 3, Census Tract 220.05, King County, Washington",852,126,389,107,463,129
1500000US530330220061,530330220061,"Block Group 1, Census Tract 220.06, King County, Washington",558,71,502,70,56,34
1500000US530330220062,530330220062,"Block Group 2, Census Tract 220.06, King County, Washington",514,72,374,82,140,59
1500000US530330220063,530330220063,"Block Group 3, Census Tract 220.06, King County, Washington",647,82,145,61,502,94
1500000US530330221011,530330221011,"Block Group 1, Census Tract 221.01, King County, Washington",564,83,402,76,162,45
1500000US530330221012,530330221012,"Block Group 2, Census Tract 221.01, King County, Washington",387,56,340,58,47,26
1500000US530330221013,530330221013,"Block Group 3, Census Tract 221.01, King County, Washington",596,79,488,63,108,69
1500000US530330221014,530330221014,"Block Group 4, Census Tract 221.01, King County, Washington",263,46,235,49,28,25
1500000US530330221021,530330221021,"Block Group 1, Census Tract 221.02, King County, Washington",1130,123,869,123,261,96
1500000US530330221022,530330221022,"Block Group 2, Census Tract 221.02, King County, Washington",286,62,254,67,32,35
1500000US530330221023,530330221023,"Block Group 3, Census Tract 221.02, King County, Washington",351,77,299,70,52,43
1500000US530330221024,530330221024,"Block Group 4, Census Tract 221.02, King County, Washington",521,65,477,71,44,38
1500000US530330222011,530330222011,"Block Group 1, Census Tract 222.01, King County, Washington",354,75,320,79,34,27
1500000US530330222012,530330222012,"Block Group 2, Census Tract 222.01, King County, Washington",273,55,265,54,8,13
1500000US530330222013,530330222013,"Block Group 3, Census Tract 222.01, King County, Washington",700,78,351,64,349,80
1500000US530330222014,530330222014,"Block Group 4, Census Tract 222.01, King County, Washington",361,59,318,61,43,31
1500000US530330222021,530330222021,"Block Group 1, Census Tract 222.02, King County, Washington",493,90,420,96,73,49
1500000US530330222022,530330222022,"Block Group 2, Census Tract 222.02, King County, Washington",639,131,395,73,244,113
1500000US530330222023,530330222023,"Block Group 3, Census Tract 222.02, King County, Washington",474,85,424,90,50,45
1500000US530330222024,530330222024,"Block Group 4, Census Tract 222.02, King County, Washington",465,68,181,65,284,72
1500000US530330222025,530330222025,"Block Group 5, Census Tract 222.02, King County, Washington",1058,162,294,81,764,169
1500000US530330222031,530330222031,"Block Group 1, Census Tract 222.03, King County, Washington",729,75,666,69,63,48
1500000US530330222032,530330222032,"Block Group 2, Census Tract 222.03, King County, Washington",691,67,610,76,81,45
1500000US530330222033,530330222033,"Block Group 3, Census Tract 222.03, King County, Washington",466,69,269,68,197,76
1500000US530330223001,530330223001,"Block Group 1, Census Tract 223, King County, Washington",602,50,579,53,23,21
1500000US530330223002,530330223002,"Block Group 2, Census Tract 223, King County, Washington",382,53,350,55,32,32
1500000US530330224001,530330224001,"Block Group 1, Census Tract 224, King County, Washington",823,144,342,96,481,127
1500000US530330224002,530330224002,"Block Group 2, Census Tract 224, King County, Washington",537,106,470,101,67,56
1500000US530330224003,530330224003,"Block Group 3, Census Tract 224, King County, Washington",593,120,482,125,111,74
1500000US530330224004,530330224004,"Block Group 4, Census Tract 224, King County, Washington",913,186,470,158,443,118
1500000US530330224005,530330224005,"Block Group 5, Census Tract 224, King County, Washington",493,137,266,76,227,137
1500000US530330224006,530330224006,"Block Group 6, Census Tract 224, King County, Washington",451,92,345,90,106,84
1500000US530330225001,530330225001,"Block Group 1, Census Tract 225, King County, Washington",523,111,347,104,176,83
1500000US530330225002,530330225002,"Block Group 2, Census Tract 225, King County, Washington",646,97,613,98,33,27
1500000US530330225003,530330225003,"Block Group 3, Census Tract 225, King County, Washington",686,136,317,112,369,163
1500000US530330225004,530330225004,"Block Group 4, Census Tract 225, King County, Washington",982,162,468,106,514,164
1500000US530330225005,530330225005,"Block Group 5, Census Tract 225, King County, Washington",1126,120,554,108,572,117
1500000US530330226031,530330226031,"Block Group 1, Census Tract 226.03, King County, Washington",416,109,205,114,211,113
1500000US530330226032,530330226032,"Block Group 2, Census Tract 226.03, King County, Washington",264,56,254,55,10,16
1500000US530330226033,530330226033,"Block Group 3, Census Tract 226.03, King County, Washington",434,103,271,96,163,90
1500000US530330226034,530330226034,"Block Group 4, Census Tract 226.03, King County, Washington",610,96,330,87,280,88
1500000US530330226035,530330226035,"Block Group 5, Census Tract 226.03, King County, Washington",564,113,357,113,207,62
1500000US530330226041,530330226041,"Block Group 1, Census Tract 226.04, King County, Washington",733,84,508,83,225,83
1500000US530330226042,530330226042,"Block Group 2, Census Tract 226.04, King County, Washington",550,70,402,67,148,68
1500000US530330226043,530330226043,"Block Group 3, Census Tract 226.04, King County, Washington",481,52,447,53,34,25
1500000US530330226051,530330226051,"Block Group 1, Census Tract 226.05, King County, Washington",1015,164,351,114,664,155
1500000US530330226052,530330226052,"Block Group 2, Census Tract 226.05, King County, Washington",693,94,563,110,130,70
1500000US530330226053,530330226053,"Block Group 3, Census Tract 226.05, King County, Washington",869,181,39,30,830,183
1500000US530330226061,530330226061,"Block Group 1, Census Tract 226.06, King County, Washington",529,103,387,90,142,78
1500000US530330226062,530330226062,"Block Group 2, Census Tract 226.06, King County, Washington",677,153,373,131,304,125
1500000US530330226063,530330226063,"Block Group 3, Census Tract 226.06, King County, Washington",602,117,457,114,145,70
1500000US530330226064,530330226064,"Block Group 4, Census Tract 226.06, King County, Washington",489,114,408,108,81,80
1500000US530330227011,530330227011,"Block Group 1, Census Tract 227.01, King County, Washington",850,95,357,68,493,91
1500000US530330227012,530330227012,"Block Group 2, Census Tract 227.01, King County, Washington",629,82,238,49,391,73
1500000US530330227021,530330227021,"Block Group 1, Census Tract 227.02, King County, Washington",598,96,440,96,158,85
1500000US530330227022,530330227022,"Block Group 2, Census Tract 227.02, King County, Washington",402,68,306,63,96,50
1500000US530330227023,530330227023,"Block Group 3, Census Tract 227.02, King County, Washington",403,61,323,52,80,48
1500000US530330227031,530330227031,"Block Group 1, Census Tract 227.03, King County, Washington",495,46,268,38,227,55
1500000US530330227032,530330227032,"Block Group 2, Census Tract 227.03, King County, Washington",344,37,302,35,42,28
1500000US530330228011,530330228011,"Block Group 1, Census Tract 228.01, King County, Washington",1323,186,297,74,1026,173
1500000US530330228012,530330228012,"Block Group 2, Census Tract 228.01, King County, Washington",1224,195,214,77,1010,197
1500000US530330228013,530330228013,"Block Group 3, Census Tract 228.01, King County, Washington",426,87,412,84,14,22
1500000US530330228014,530330228014,"Block Group 4, Census Tract 228.01, King County, Washington",797,134,324,89,473,133
1500000US530330228021,530330228021,"Block Group 1, Census Tract 228.02, King County, Washington",782,88,408,72,374,83
1500000US530330228022,530330228022,"Block Group 2, Census Tract 228.02, King County, Washington",649,80,492,71,157,63
1500000US530330228023,530330228023,"Block Group 3, Census Tract 228.02, King County, Washington",609,72,519,75,90,61
1500000US530330228031,530330228031,"Block Group 1, Census Tract 228.03, King County, Washington",339,87,8,17,331,89
1500000US530330228032,530330228032,"Block Group 2, Census Tract 228.03, King County, Washington",1013,164,612,105,401,113
1500000US530330228033,530330228033,"Block Group 3, Census Tract 228.03, King County, Washington",852,150,11,20,841,152
1500000US530330229011,530330229011,"Block Group 1, Census Tract 229.01, King County, Washington",540,60,399,61,141,60
1500000US530330229012,530330229012,"Block Group 2, Census Tract 229.01, King County, Washington",462,55,382,58,80,50
1500000US530330229021,530330229021,"Block Group 1, Census Tract 229.02, King County, Washington",602,102,520,93,82,84
1500000US530330229022,530330229022,"Block Group 2, Census Tract 229.02, King County, Washington",296,53,282,57,14,21
1500000US530330229023,530330229023,"Block Group 3, Census Tract 229.02, King County, Washington",314,81,218,77,96,68
1500000US530330229024,530330229024,"Block Group 4, Census Tract 229.02, King County, Washington",790,127,340,108,450,128
1500000US530330229025,530330229025,"Block Group 5, Census Tract 229.02, King County, Washington",392,78,320,78,72,48
1500000US530330230001,530330230001,"Block Group 1, Census Tract 230, King County, Washington",429,56,383,63,46,32
1500000US530330230002,530330230002,"Block Group 2, Census Tract 230, King County, Washington",462,57,405,59,57,37
1500000US530330230003,530330230003,"Block Group 3, Census Tract 230, King County, Washington",431,56,369,58,62,34
1500000US530330230004,530330230004,"Block Group 4, Census Tract 230, King County, Washington",458,71,398,68,60,56
1500000US530330231001,530330231001,"Block Group 1, Census Tract 231, King County, Washington",390,54,236,55,154,61
1500000US530330231002,530330231002,"Block Group 2, Census Tract 231, King County, Washington",413,54,317,60,96,48
1500000US530330231003,530330231003,"Block Group 3, Census Tract 231, King County, Washington",559,69,485,77,74,50
1500000US530330232011,530330232011,"Block Group 1, Census Tract 232.01, King County, Washington",481,140,253,94,228,115
1500000US530330232012,530330232012,"Block Group 2, Census Tract 232.01, King County, Washington",941,213,368,120,573,181
1500000US530330232013,530330232013,"Block Group 3, Census Tract 232.01, King County, Washington",1201,228,177,56,1024,228
1500000US530330232021,530330232021,"Block Group 1, Census Tract 232.02, King County, Washington",789,129,192,53,597,127
1500000US530330232022,530330232022,"Block Group 2, Census Tract 232.02, King County, Washington",462,85,294,70,168,78
1500000US530330232023,530330232023,"Block Group 3, Census Tract 232.02, King County, Washington",556,110,42,38,514,106
1500000US530330233001,530330233001,"Block Group 1, Census Tract 233, King County, Washington",637,103,620,106,17,28
1500000US530330233002,530330233002,"Block Group 2, Census Tract 233, King County, Washington",419,115,363,115,56,67
1500000US530330233003,530330233003,"Block Group 3, Census Tract 233, King County, Washington",643,128,368,96,275,136
1500000US530330233004,530330233004,"Block Group 4, Census Tract 233, King County, Washington",590,119,436,113,154,91
1500000US530330234011,530330234011,"Block Group 1, Census Tract 234.01, King County, Washington",428,70,283,47,145,70
1500000US530330234012,530330234012,"Block Group 2, Census Tract 234.01, King County, Washington",716,72,432,76,284,87
1500000US530330234013,530330234013,"Block Group 3, Census Tract 234.01, King County, Washington",356,75,195,49,161,71
1500000US530330234031,530330234031,"Block Group 1, Census Tract 234.03, King County, Washington",617,75,346,68,271,74
1500000US530330234032,530330234032,"Block Group 2, Census Tract 234.03, King County, Washington",492,70,396,72,96,61
1500000US530330234033,530330234033,"Block Group 3, Census Tract 234.03, King County, Washington",497,65,459,55,38,46
1500000US530330234041,530330234041,"Block Group 1, Census Tract 234.04, King County, Washington",720,72,583,82,137,69
1500000US530330234042,530330234042,"Block Group 2, Census Tract 234.04, King County, Washington",462,59,417,54,45,39
1500000US530330235001,530330235001,"Block Group 1, Census Tract 235, King County, Washington",420,52,404,54,16,19
1500000US530330235002,530330235002,"Block Group 2, Census Tract 235, King County, Washington",447,65,296,67,151,49
1500000US530330235003,530330235003,"Block Group 3, Census Tract 235, King County, Washington",586,73,336,60,250,69
1500000US530330236011,530330236011,"Block Group 1, Census Tract 236.01, King County, Washington",714,87,410,87,304,64
1500000US530330236012,530330236012,"Block Group 2, Census Tract 236.01, King County, Washington",651,87,198,53,453,83
1500000US530330236013,530330236013,"Block Group 3, Census Tract 236.01, King County, Washington",341,72,284,62,57,50
1500000US530330236031,530330236031,"Block Group 1, Census Tract 236.03, King County, Washington",489,120,165,75,324,108
1500000US530330236032,530330236032,"Block Group 2, Census Tract 236.03, King County, Washington",895,160,0,12,895,160
1500000US530330236033,530330236033,"Block Group 3, Census Tract 236.03, King County, Washington",445,97,334,89,111,68
1500000US530330236034,530330236034,"Block Group 4, Census Tract 236.03, King County, Washington",527,131,117,80,410,127
1500000US530330236041,530330236041,"Block Group 1, Census Tract 236.04, King County, Washington",1034,156,290,81,744,159
1500000US530330236042,530330236042,"Block Group 2, Census Tract 236.04, King County, Washington",323,68,231,72,92,35
1500000US530330236043,530330236043,"Block Group 3, Census Tract 236.04, King County, Washington",801,143,349,106,452,138
1500000US530330236044,530330236044,"Block Group 4, Census Tract 236.04, King County, Washington",349,93,179,63,170,79
1500000US530330237001,530330237001,"Block Group 1, Census Tract 237, King County, Washington",289,60,246,60,43,33
1500000US530330237002,530330237002,"Block Group 2, Census Tract 237, King County, Washington",682,75,628,78,54,40
1500000US530330237003,530330237003,"Block Group 3, Census Tract 237, King County, Washington",760,82,300,75,460,94
1500000US530330238011,530330238011,"Block Group 1, Census Tract 238.01, King County, Washington",684,94,390,80,294,90
1500000US530330238012,530330238012,"Block Group 2, Census Tract 238.01, King County, Washington",530,92,187,50,343,76
1500000US530330238031,530330238031,"Block Group 1, Census Tract 238.03, King County, Washington",1483,222,295,97,1188,209
1500000US530330238032,530330238032,"Block Group 2, Census Tract 238.03, King County, Washington",1330,184,108,60,1222,184
1500000US530330238041,530330238041,"Block Group 1, Census Tract 238.04, King County, Washington",882,143,368,108,514,115
1500000US530330238042,530330238042,"Block Group 2, Census Tract 238.04, King County, Washington",1135,168,574,133,561,143
1500000US530330238043,530330238043,"Block Group 3, Census Tract 238.04, King County, Washington",1982,258,123,82,1859,246
1500000US530330239001,530330239001,"Block Group 1, Census Tract 239, King County, Washington",977,143,418,86,559,137
1500000US530330239002,530330239002,"Block Group 2, Census Tract 239, King County, Washington",571,101,473,78,98,91
1500000US530330239003,530330239003,"Block Group 3, Census Tract 239, King County, Washington",691,127,669,127,22,17
1500000US530330239004,530330239004,"Block Group 4, Census Tract 239, King County, Washington",546,96,436,71,110,79
1500000US530330240001,530330240001,"Block Group 1, Census Tract 240, King County, Washington",755,149,444,103,311,125
1500000US530330240002,530330240002,"Block Group 2, Census Tract 240, King County, Washington",678,128,602,125,76,65
1500000US530330240003,530330240003,"Block Group 3, Census Tract 240, King County, Washington",976,146,410,125,566,150
1500000US530330240004,530330240004,"Block Group 4, Census Tract 240, King County, Washington",941,135,594,127,347,141
1500000US530330241001,530330241001,"Block Group 1, Census Tract 241, King County, Washington",384,42,354,46,30,16
1500000US530330241002,530330241002,"Block Group 2, Census Tract 241, King County, Washington",366,34,329,32,37,19
1500000US530330241003,530330241003,"Block Group 3, Census Tract 241, King County, Washington",542,43,495,45,47,19
1500000US530330241004,530330241004,"Block Group 4, Census Tract 241, King County, Washington",400,34,375,37,25,16
1500000US530330242001,530330242001,"Block Group 1, Census Tract 242, King County, Washington",495,56,465,57,30,19
1500000US530330242002,530330242002,"Block Group 2, Census Tract 242, King County, Washington",642,62,554,72,88,49
1500000US530330243001,530330243001,"Block Group 1, Census Tract 243, King County, Washington",582,99,537,106,45,44
1500000US530330243002,530330243002,"Block Group 2, Census Tract 243, King County, Washington",1359,188,495,122,864,160
1500000US530330243003,530330243003,"Block Group 3, Census Tract 243, King County, Washington",489,125,405,109,84,83
1500000US530330243004,530330243004,"Block Group 4, Census Tract 243, King County, Washington",999,145,469,113,530,139
1500000US530330243005,530330243005,"Block Group 5, Census Tract 243, King County, Washington",432,80,381,76,51,47
1500000US530330244001,530330244001,"Block Group 1, Census Tract 244, King County, Washington",560,78,305,57,255,75
1500000US530330244002,530330244002,"Block Group 2, Census Tract 244, King County, Washington",715,87,155,46,560,81
1500000US530330245001,530330245001,"Block Group 1, Census Tract 245, King County, Washington",810,76,663,87,147,60
1500000US530330245002,530330245002,"Block Group 2, Census Tract 245, King County, Washington",492,69,424,71,68,35
1500000US530330245003,530330245003,"Block Group 3, Census Tract 245, King County, Washington",440,57,407,63,33,25
1500000US530330246011,530330246011,"Block Group 1, Census Tract 246.01, King County, Washington",607,75,543,77,64,36
1500000US530330246012,530330246012,"Block Group 2, Census Tract 246.01, King County, Washington",508,67,490,68,18,20
1500000US530330246013,530330246013,"Block Group 3, Census Tract 246.01, King County, Washington",544,53,534,53,10,16
1500000US530330246021,530330246021,"Block Group 1, Census Tract 246.02, King County, Washington",327,58,312,53,15,22
1500000US530330246022,530330246022,"Block Group 2, Census Tract 246.02, King County, Washington",703,76,703,76,0,12
1500000US530330246023,530330246023,"Block Group 3, Census Tract 246.02, King County, Washington",253,50,199,39,54,39
1500000US530330247011,530330247011,"Block Group 1, Census Tract 247.01, King County, Washington",470,74,340,75,130,72
1500000US530330247012,530330247012,"Block Group 2, Census Tract 247.01, King County, Washington",554,105,283,71,271,99
1500000US530330247013,530330247013,"Block Group 3, Census Tract 247.01, King County, Washington",382,80,349,86,33,32
1500000US530330247021,530330247021,"Block Group 1, Census Tract 247.02, King County, Washington",751,138,614,144,137,94
1500000US530330247022,530330247022,"Block Group 2, Census Tract 247.02, King County, Washington",493,88,401,80,92,54
1500000US530330247023,530330247023,"Block Group 3, Census Tract 247.02, King County, Washington",639,95,558,107,81,73
1500000US530330247024,530330247024,"Block Group 4, Census Tract 247.02, King County, Washington",571,94,514,106,57,50
1500000US530330247025,530330247025,"Block Group 5, Census Tract 247.02, King County, Washington",507,127,401,107,106,107
1500000US530330248001,530330248001,"Block Group 1, Census Tract 248, King County, Washington",373,70,218,66,155,77
1500000US530330248002,530330248002,"Block Group 2, Census Tract 248, King County, Washington",736,109,509,91,227,116
1500000US530330248003,530330248003,"Block Group 3, Census Tract 248, King County, Washington",1066,142,466,94,600,156
1500000US530330249011,530330249011,"Block Group 1, Census Tract 249.01, King County, Washington",377,57,332,55,45,45
1500000US530330249012,530330249012,"Block Group 2, Census Tract 249.01, King County, Washington",640,67,591,71,49,34
1500000US530330249013,530330249013,"Block Group 3, Census Tract 249.01, King County, Washington",374,42,363,41,11,16
1500000US530330249014,530330249014,"Block Group 4, Census Tract 249.01, King County, Washington",414,64,384,67,30,22
1500000US530330249021,530330249021,"Block Group 1, Census Tract 249.02, King County, Washington",399,54,302,61,97,59
1500000US530330249022,530330249022,"Block Group 2, Census Tract 249.02, King County, Washington",548,71,499,73,49,28
1500000US530330249023,530330249023,"Block Group 3, Census Tract 249.02, King County, Washington",411,62,299,57,112,70
1500000US530330249031,530330249031,"Block Group 1, Census Tract 249.03, King County, Washington",653,73,585,78,68,54
1500000US530330249032,530330249032,"Block Group 2, Census Tract 249.03, King County, Washington",619,74,567,82,52,46
1500000US530330249033,530330249033,"Block Group 3, Census Tract 249.03, King County, Washington",447,68,375,70,72,48
1500000US530330249034,530330249034,"Block Group 4, Census Tract 249.03, King County, Washington",521,70,505,73,16,23
1500000US530330250011,530330250011,"Block Group 1, Census Tract 250.01, King County, Washington",350,54,340,54,10,15
1500000US530330250012,530330250012,"Block Group 2, Census Tract 250.01, King County, Washington",673,97,436,73,237,74
1500000US530330250013,530330250013,"Block Group 3, Census Tract 250.01, King County, Washington",430,57,405,59,25,23
1500000US530330250014,530330250014,"Block Group 4, Census Tract 250.01, King County, Washington",387,63,352,71,35,28
1500000US530330250031,530330250031,"Block Group 1, Census Tract 250.03, King County, Washington",375,82,363,85,12,21
1500000US530330250032,530330250032,"Block Group 2, Census Tract 250.03, King County, Washington",374,95,331,80,43,66
1500000US530330250033,530330250033,"Block Group 3, Census Tract 250.03, King County, Washington",546,98,311,70,235,94
1500000US530330250034,530330250034,"Block Group 4, Census Tract 250.03, King County, Washington",522,108,474,104,48,43
1500000US530330250035,530330250035,"Block Group 5, Census Tract 250.03, King County, Washington",769,139,309,94,460,123
1500000US530330250051,530330250051,"Block Group 1, Census Tract 250.05, King County, Washington",974,91,936,91,38,25
1500000US530330250052,530330250052,"Block Group 2, Census Tract 250.05, King County, Washington",960,103,431,88,529,92
1500000US530330250061,530330250061,"Block Group 1, Census Tract 250.06, King County, Washington",467,125,355,107,112,99
1500000US530330250062,530330250062,"Block Group 2, Census Tract 250.06, King County, Washington",1212,127,714,122,498,146
1500000US530330250063,530330250063,"Block Group 3, Census Tract 250.06, King County, Washington",549,90,527,89,22,26
1500000US530330251011,530330251011,"Block Group 1, Census Tract 251.01, King County, Washington",603,119,152,74,451,131
1500000US530330251012,530330251012,"Block Group 2, Census Tract 251.01, King County, Washington",533,124,336,89,197,100
1500000US530330251013,530330251013,"Block Group 3, Census Tract 251.01, King County, Washington",325,77,239,76,86,61
1500000US530330251014,530330251014,"Block Group 4, Census Tract 251.01, King County, Washington",652,100,606,106,46,42
1500000US530330251021,530330251021,"Block Group 1, Census Tract 251.02, King County, Washington",393,97,287,95,106,80
1500000US530330251022,530330251022,"Block Group 2, Census Tract 251.02, King County, Washington",581,172,327,96,254,154
1500000US530330251023,530330251023,"Block Group 3, Census Tract 251.02, King County, Washington",1134,157,1050,151,84,72
1500000US530330251024,530330251024,"Block Group 4, Census Tract 251.02, King County, Washington",643,139,303,80,340,133
1500000US530330252001,530330252001,"Block Group 1, Census Tract 252, King County, Washington",458,103,348,100,110,62
1500000US530330252002,530330252002,"Block Group 2, Census Tract 252, King County, Washington",1010,127,746,132,264,130
1500000US530330252003,530330252003,"Block Group 3, Census Tract 252, King County, Washington",481,132,263,83,218,118
1500000US530330252004,530330252004,"Block Group 4, Census Tract 252, King County, Washington",822,115,496,90,326,83
1500000US530330252005,530330252005,"Block Group 5, Census Tract 252, King County, Washington",482,89,400,90,82,41
1500000US530330253011,530330253011,"Block Group 1, Census Tract 253.01, King County, Washington",702,138,216,72,486,134
1500000US530330253012,530330253012,"Block Group 2, Census Tract 253.01, King County, Washington",800,144,502,130,298,149
1500000US530330253013,530330253013,"Block Group 3, Census Tract 253.01, King County, Washington",1343,221,275,112,1068,202
1500000US530330253021,530330253021,"Block Group 1, Census Tract 253.02, King County, Washington",1089,151,116,69,973,160
1500000US530330253022,530330253022,"Block Group 2, Census Tract 253.02, King County, Washington",833,160,175,77,658,167
1500000US530330253023,530330253023,"Block Group 3, Census Tract 253.02, King County, Washington",704,168,30,34,674,174
1500000US530330254001,530330254001,"Block Group 1, Census Tract 254, King County, Washington",575,149,238,82,337,158
1500000US530330254002,530330254002,"Block Group 2, Census Tract 254, King County, Washington",951,188,125,61,826,189
1500000US530330254003,530330254003,"Block Group 3, Census Tract 254, King County, Washington",1115,203,250,110,865,187
1500000US530330254004,530330254004,"Block Group 4, Census Tract 254, King County, Washington",435,116,229,88,206,95
1500000US530330255001,530330255001,"Block Group 1, Census Tract 255, King County, Washington",1002,106,180,57,822,120
1500000US530330255002,530330255002,"Block Group 2, Census Tract 255, King County, Washington",534,95,358,93,176,76
1500000US530330255003,530330255003,"Block Group 3, Census Tract 255, King County, Washington",459,89,331,84,128,71
1500000US530330256011,530330256011,"Block Group 1, Census Tract 256.01, King County, Washington",369,59,355,56,14,20
1500000US530330256012,530330256012,"Block Group 2, Census Tract 256.01, King County, Washington",973,93,414,90,559,114
1500000US530330256013,530330256013,"Block Group 3, Census Tract 256.01, King County, Washington",665,72,484,76,181,70
1500000US530330256021,530330256021,"Block Group 1, Census Tract 256.02, King County, Washington",740,86,674,84,66,48
1500000US530330256022,530330256022,"Block Group 2, Census Tract 256.02, King County, Washington",365,73,365,73,0,12
1500000US530330256023,530330256023,"Block Group 3, Census Tract 256.02, King County, Washington",939,94,890,101,49,37
1500000US530330257011,530330257011,"Block Group 1, Census Tract 257.01, King County, Washington",560,135,298,93,262,113
1500000US530330257012,530330257012,"Block Group 2, Census Tract 257.01, King County, Washington",469,123,294,113,175,68
1500000US530330257013,530330257013,"Block Group 3, Census Tract 257.01, King County, Washington",331,102,71,47,260,96
1500000US530330257014,530330257014,"Block Group 4, Census Tract 257.01, King County, Washington",664,132,196,98,468,123
1500000US530330257015,530330257015,"Block Group 5, Census Tract 257.01, King County, Washington",731,153,26,31,705,153
1500000US530330257021,530330257021,"Block Group 1, Census Tract 257.02, King County, Washington",533,82,312,64,221,66
1500000US530330257022,530330257022,"Block Group 2, Census Tract 257.02, King County, Washington",348,59,320,64,28,23
1500000US530330257023,530330257023,"Block Group 3, Census Tract 257.02, King County, Washington",363,59,263,63,100,62
1500000US530330258031,530330258031,"Block Group 1, Census Tract 258.03, King County, Washington",525,74,484,79,41,32
1500000US530330258032,530330258032,"Block Group 2, Census Tract 258.03, King County, Washington",630,88,402,76,228,77
1500000US530330258033,530330258033,"Block Group 3, Census Tract 258.03, King County, Washington",631,100,35,23,596,100
1500000US530330258041,530330258041,"Block Group 1, Census Tract 258.04, King County, Washington",417,62,317,69,100,53
1500000US530330258042,530330258042,"Block Group 2, Census Tract 258.04, King County, Washington",302,51,265,54,37,28
1500000US530330258043,530330258043,"Block Group 3, Census Tract 258.04, King County, Washington",448,77,356,83,92,34
1500000US530330258051,530330258051,"Block Group 1, Census Tract 258.05, King County, Washington",906,112,364,92,542,112
1500000US530330258052,530330258052,"Block Group 2, Census Tract 258.05, King County, Washington",370,101,301,92,69,49
1500000US530330258053,530330258053,"Block Group 3, Census Tract 258.05, King County, Washington",619,89,338,74,281,72
1500000US530330258061,530330258061,"Block Group 1, Census Tract 258.06, King County, Washington",426,57,367,61,59,41
1500000US530330258062,530330258062,"Block Group 2, Census Tract 258.06, King County, Washington",821,100,310,78,511,97
1500000US530330258063,530330258063,"Block Group 3, Census Tract 258.06, King County, Washington",481,86,277,59,204,81
1500000US530330260011,530330260011,"Block Group 1, Census Tract 260.01, King County, Washington",512,106,351,78,161,88
1500000US530330260012,530330260012,"Block Group 2, Census Tract 260.01, King County, Washington",349,68,266,67,83,47
1500000US530330260013,530330260013,"Block Group 3, Census Tract 260.01, King County, Washington",441,99,374,99,67,60
1500000US530330260014,530330260014,"Block Group 4, Census Tract 260.01, King County, Washington",337,80,283,74,54,42
1500000US530330260015,530330260015,"Block Group 5, Census Tract 260.01, King County, Washington",402,101,263,80,139,82
1500000US530330260021,530330260021,"Block Group 1, Census Tract 260.02, King County, Washington",1013,166,197,92,816,169
1500000US530330260022,530330260022,"Block Group 2, Census Tract 260.02, King County, Washington",711,163,363,124,348,131
1500000US530330260023,530330260023,"Block Group 3, Census Tract 260.02, King County, Washington",623,137,360,104,263,124
1500000US530330260024,530330260024,"Block Group 4, Census Tract 260.02, King County, Washington",692,162,507,135,185,109
1500000US530330261001,530330261001,"Block Group 1, Census Tract 261, King County, Washington",350,95,290,98,60,57
1500000US530330261002,530330261002,"Block Group 2, Census Tract 261, King County, Washington",550,138,111,62,439,129
1500000US530330261003,530330261003,"Block Group 3, Census Tract 261, King County, Washington",572,166,232,96,340,165
1500000US530330261004,530330261004,"Block Group 4, Census Tract 261, King County, Washington",598,125,300,106,298,114
1500000US530330261005,530330261005,"Block Group 5, Census Tract 261, King County, Washington",524,174,203,105,321,160
1500000US530330262001,530330262001,"Block Group 1, Census Tract 262, King County, Washington",73,63,20,22,53,63
1500000US530330262002,530330262002,"Block Group 2, Census Tract 262, King County, Washington",613,126,150,52,463,127
1500000US530330262003,530330262003,"Block Group 3, Census Tract 262, King County, Washington",951,144,261,92,690,150
1500000US530330262004,530330262004,"Block Group 4, Census Tract 262, King County, Washington",677,108,272,77,405,106
1500000US530330263001,530330263001,"Block Group 1, Census Tract 263, King County, Washington",209,48,114,32,95,49
1500000US530330263002,530330263002,"Block Group 2, Census Tract 263, King County, Washington",358,52,253,47,105,42
1500000US530330264001,530330264001,"Block Group 1, Census Tract 264, King County, Washington",321,129,35,38,286,131
1500000US530330264002,530330264002,"Block Group 2, Census Tract 264, King County, Washington",600,147,197,106,403,147
1500000US530330264003,530330264003,"Block Group 3, Census Tract 264, King County, Washington",479,128,358,98,121,93
1500000US530330264004,530330264004,"Block Group 4, Census Tract 264, King County, Washington",524,129,274,98,250,103
1500000US530330264005,530330264005,"Block Group 5, Census Tract 264, King County, Washington",523,144,102,72,421,140
1500000US530330265001,530330265001,"Block Group 1, Census Tract 265, King County, Washington",338,66,70,31,268,64
1500000US530330265002,530330265002,"Block Group 2, Census Tract 265, King County, Washington",593,113,71,36,522,111
1500000US530330265003,530330265003,"Block Group 3, Census Tract 265, King County, Washington",518,112,328,87,190,90
1500000US530330266001,530330266001,"Block Group 1, Census Tract 266, King County, Washington",426,61,245,43,181,63
1500000US530330266002,530330266002,"Block Group 2, Census Tract 266, King County, Washington",446,68,352,60,94,47
1500000US530330267001,530330267001,"Block Group 1, Census Tract 267, King County, Washington",380,98,239,93,141,86
1500000US530330267002,530330267002,"Block Group 2, Census Tract 267, King County, Washington",654,131,284,95,370,119
1500000US530330267003,530330267003,"Block Group 3, Census Tract 267, King County, Washington",503,90,482,93,21,31
1500000US530330267004,530330267004,"Block Group 4, Census Tract 267, King County, Washington",425,86,404,83,21,33
1500000US530330268011,530330268011,"Block Group 1, Census Tract 268.01, King County, Washington",407,115,328,107,79,62
1500000US530330268012,530330268012,"Block Group 2, Census Tract 268.01, King County, Washington",570,152,186,77,384,149
1500000US530330268013,530330268013,"Block Group 3, Census Tract 268.01, King County, Washington",469,133,63,53,406,147
1500000US530330268014,530330268014,"Block Group 4, Census Tract 268.01, King County, Washington",549,148,113,51,436,144
1500000US530330268021,530330268021,"Block Group 1, Census Tract 268.02, King County, Washington",452,103,183,82,269,92
1500000US530330268022,530330268022,"Block Group 2, Census Tract 268.02, King County, Washington",232,61,115,44,117,57
1500000US530330268023,530330268023,"Block Group 3, Census Tract 268.02, King County, Washington",585,114,253,79,332,112
1500000US530330268024,530330268024,"Block Group 4, Census Tract 268.02, King County, Washington",381,71,246,60,135,64
1500000US530330270001,530330270001,"Block Group 1, Census Tract 270, King County, Washington",393,71,288,61,105,57
1500000US530330270002,530330270002,"Block Group 2, Census Tract 270, King County, Washington",273,52,197,45,76,47
1500000US530330270003,530330270003,"Block Group 3, Census Tract 270, King County, Washington",480,72,289,59,191,66
1500000US530330271001,530330271001,"Block Group 1, Census Tract 271, King County, Washington",501,104,68,43,433,104
1500000US530330271002,530330271002,"Block Group 2, Census Tract 271, King County, Washington",694,133,390,112,304,107
1500000US530330272001,530330272001,"Block Group 1, Census Tract 272, King County, Washington",355,59,294,53,61,34
1500000US530330272002,530330272002,"Block Group 2, Census Tract 272, King County, Washington",508,64,199,54,309,62
1500000US530330273001,530330273001,"Block Group 1, Census Tract 273, King County, Washington",402,74,250,56,152,57
1500000US530330273002,530330273002,"Block Group 2, Census Tract 273, King County, Washington",681,108,70,32,611,105
1500000US530330273003,530330273003,"Block Group 3, Census Tract 273, King County, Washington",332,78,234,70,98,67
1500000US530330273004,530330273004,"Block Group 4, Census Tract 273, King County, Washington",475,90,354,76,121,63
1500000US530330274001,530330274001,"Block Group 1, Census Tract 274, King County, Washington",530,100,408,99,122,69
1500000US530330274002,530330274002,"Block Group 2, Census Tract 274, King County, Washington",327,96,224,84,103,70
1500000US530330274003,530330274003,"Block Group 3, Census Tract 274, King County, Washington",580,90,360,78,220,70
1500000US530330274004,530330274004,"Block Group 4, Census Tract 274, King County, Washington",289,79,248,67,41,50
1500000US530330275001,530330275001,"Block Group 1, Census Tract 275, King County, Washington",588,84,343,70,245,86
1500000US530330275002,530330275002,"Block Group 2, Census Tract 275, King County, Washington",360,66,222,53,138,70
1500000US530330275003,530330275003,"Block Group 3, Census Tract 275, King County, Washington",395,72,164,57,231,67
1500000US530330275004,530330275004,"Block Group 4, Census Tract 275, King County, Washington",376,80,233,59,143,70
1500000US530330276001,530330276001,"Block Group 1, Census Tract 276, King County, Washington",464,100,227,54,237,92
1500000US530330276002,530330276002,"Block Group 2, Census Tract 276, King County, Washington",826,118,250,64,576,130
1500000US530330276003,530330276003,"Block Group 3, Census Tract 276, King County, Washington",373,72,340,66,33,41
1500000US530330277011,530330277011,"Block Group 1, Census Tract 277.01, King County, Washington",603,171,336,126,267,137
1500000US530330277012,530330277012,"Block Group 2, Census Tract 277.01, King County, Washington",302,82,265,82,37,41
1500000US530330277013,530330277013,"Block Group 3, Census Tract 277.01, King County, Washington",394,140,282,87,112,124
1500000US530330277014,530330277014,"Block Group 4, Census Tract 277.01, King County, Washington",628,168,421,86,207,155
1500000US530330277015,530330277015,"Block Group 5, Census Tract 277.01, King County, Washington",504,162,355,112,149,131
1500000US530330277021,530330277021,"Block Group 1, Census Tract 277.02, King County, Washington",374,107,285,100,89,69
1500000US530330277022,530330277022,"Block Group 2, Census Tract 277.02, King County, Washington",563,137,511,136,52,48
1500000US530330277023,530330277023,"Block Group 3, Census Tract 277.02, King County, Washington",617,153,532,134,85,89
1500000US530330277024,530330277024,"Block Group 4, Census Tract 277.02, King County, Washington",650,138,603,135,47,54
1500000US530330278001,530330278001,"Block Group 1, Census Tract 278, King County, Washington",447,58,367,58,80,44
1500000US530330278002,530330278002,"Block Group 2, Census Tract 278, King County, Washington",440,72,415,71,25,20
1500000US530330278003,530330278003,"Block Group 3, Census Tract 278, King County, Washington",507,75,484,74,23,20
1500000US530330279001,530330279001,"Block Group 1, Census Tract 279, King County, Washington",451,133,173,73,278,126
1500000US530330279002,530330279002,"Block Group 2, Census Tract 279, King County, Washington",810,139,119,91,691,152
1500000US530330279003,530330279003,"Block Group 3, Census Tract 279, King County, Washington",545,162,227,115,318,131
1500000US530330279004,530330279004,"Block Group 4, Census Tract 279, King County, Washington",412,121,227,83,185,130
1500000US530330279005,530330279005,"Block Group 5, Census Tract 279, King County, Washington",361,97,306,86,55,44
1500000US530330279006,530330279006,"Block Group 6, Census Tract 279, King County, Washington",540,110,393,92,147,86
1500000US530330280001,530330280001,"Block Group 1, Census Tract 280, King County, Washington",518,96,59,30,459,90
1500000US530330280002,530330280002,"Block Group 2, Census Tract 280, King County, Washington",547,95,0,12,547,95
1500000US530330280003,530330280003,"Block Group 3, Census Tract 280, King County, Washington",482,93,141,45,341,86
1500000US530330281001,530330281001,"Block Group 1, Census Tract 281, King County, Washington",430,66,152,39,278,62
1500000US530330281002,530330281002,"Block Group 2, Census Tract 281, King County, Washington",393,73,132,46,261,64
1500000US530330282001,530330282001,"Block Group 1, Census Tract 282, King County, Washington",743,136,189,58,554,143
1500000US530330282002,530330282002,"Block Group 2, Census Tract 282, King County, Washington",668,109,261,81,407,92
1500000US530330282003,530330282003,"Block Group 3, Census Tract 282, King County, Washington",486,121,83,42,403,114
1500000US530330283001,530330283001,"Block Group 1, Census Tract 283, King County, Washington",460,60,429,59,31,28
1500000US530330283002,530330283002,"Block Group 2, Census Tract 283, King County, Washington",456,95,330,87,126,79
1500000US530330283003,530330283003,"Block Group 3, Census Tract 283, King County, Washington",1018,126,738,116,280,103
1500000US530330284021,530330284021,"Block Group 1, Census Tract 284.02, King County, Washington",287,70,115,36,172,66
1500000US530330284022,530330284022,"Block Group 2, Census Tract 284.02, King County, Washington",436,111,237,60,199,103
1500000US530330284023,530330284023,"Block Group 3, Census Tract 284.02, King County, Washington",458,81,384,82,74,52
1500000US530330284024,530330284024,"Block Group 4, Census Tract 284.02, King County, Washington",612,104,12,16,600,102
1500000US530330284031,530330284031,"Block Group 1, Census Tract 284.03, King County, Washington",1306,168,209,85,1097,182
1500000US530330284032,530330284032,"Block Group 2, Census Tract 284.03, King County, Washington",612,125,475,122,137,59
1500000US530330284033,530330284033,"Block Group 3, Census Tract 284.03, King County, Washington",474,119,350,105,124,75
1500000US530330285001,530330285001,"Block Group 1, Census Tract 285, King County, Washington",429,75,296,66,133,53
1500000US530330285002,530330285002,"Block Group 2, Census Tract 285, King County, Washington",495,86,346,66,149,80
1500000US530330285003,530330285003,"Block Group 3, Census Tract 285, King County, Washington",705,110,209,72,496,123
1500000US530330286001,530330286001,"Block Group 1, Census Tract 286, King County, Washington",325,67,297,78,28,35
1500000US530330286002,530330286002,"Block Group 2, Census Tract 286, King County, Washington",397,105,289,78,108,91
1500000US530330286003,530330286003,"Block Group 3, Census Tract 286, King County, Washington",426,83,380,83,46,40
1500000US530330286004,530330286004,"Block Group 4, Census Tract 286, King County, Washington",434,111,376,85,58,75
1500000US530330286005,530330286005,"Block Group 5, Census Tract 286, King County, Washington",629,127,322,83,307,120
1500000US530330286006,530330286006,"Block Group 6, Census Tract 286, King County, Washington",444,110,235,77,209,86
1500000US530330287001,530330287001,"Block Group 1, Census Tract 287, King County, Washington",331,69,252,69,79,38
1500000US530330287002,530330287002,"Block Group 2, Census Tract 287, King County, Washington",456,90,410,87,46,49
1500000US530330287003,530330287003,"Block Group 3, Census Tract 287, King County, Washington",602,91,548,87,54,52
1500000US530330287004,530330287004,"Block Group 4, Census Tract 287, King County, Washington",451,70,367,72,84,60
1500000US530330288011,530330288011,"Block Group 1, Census Tract 288.01, King County, Washington",433,63,208,48,225,49
1500000US530330288012,530330288012,"Block Group 2, Census Tract 288.01, King County, Washington",290,46,172,51,118,51
1500000US530330288013,530330288013,"Block Group 3, Census Tract 288.01, King County, Washington",23,14,13,13,10,12
1500000US530330288021,530330288021,"Block Group 1, Census Tract 288.02, King County, Washington",730,139,342,100,388,128
1500000US530330288022,530330288022,"Block Group 2, Census Tract 288.02, King County, Washington",499,93,347,88,152,90
1500000US530330288023,530330288023,"Block Group 3, Census Tract 288.02, King County, Washington",323,97,68,62,255,103
1500000US530330288024,530330288024,"Block Group 4, Census Tract 288.02, King County, Washington",755,126,94,69,661,133
1500000US530330289011,530330289011,"Block Group 1, Census Tract 289.01, King County, Washington",432,99,222,84,210,74
1500000US530330289012,530330289012,"Block Group 2, Census Tract 289.01, King County, Washington",275,71,113,59,162,54
1500000US530330289013,530330289013,"Block Group 3, Census Tract 289.01, King County, Washington",454,95,330,92,124,80
1500000US530330289014,530330289014,"Block Group 4, Census Tract 289.01, King County, Washington",434,77,241,64,193,59
1500000US530330289021,530330289021,"Block Group 1, Census Tract 289.02, King County, Washington",415,149,110,88,305,143
1500000US530330289022,530330289022,"Block Group 2, Census Tract 289.02, King County, Washington",565,129,351,90,214,101
1500000US530330289023,530330289023,"Block Group 3, Census Tract 289.02, King County, Washington",434,137,45,35,389,135
1500000US530330289024,530330289024,"Block Group 4, Census Tract 289.02, King County, Washington",474,125,137,59,337,124
1500000US530330289025,530330289025,"Block Group 5, Census Tract 289.02, King County, Washington",565,158,199,80,366,153
1500000US530330290011,530330290011,"Block Group 1, Census Tract 290.01, King County, Washington",371,71,208,58,163,55
1500000US530330290012,530330290012,"Block Group 2, Census Tract 290.01, King County, Washington",404,87,217,72,187,61
1500000US530330290013,530330290013,"Block Group 3, Census Tract 290.01, King County, Washington",504,86,369,78,135,73
1500000US530330290014,530330290014,"Block Group 4, Census Tract 290.01, King County, Washington",767,93,731,93,36,28
1500000US530330290031,530330290031,"Block Group 1, Census Tract 290.03, King County, Washington",379,103,34,28,345,106
1500000US530330290032,530330290032,"Block Group 2, Census Tract 290.03, King County, Washington",418,118,192,63,226,130
1500000US530330290033,530330290033,"Block Group 3, Census Tract 290.03, King County, Washington",503,109,187,78,316,101
1500000US530330290034,530330290034,"Block Group 4, Census Tract 290.03, King County, Washington",423,120,127,52,296,120
1500000US530330290035,530330290035,"Block Group 5, Census Tract 290.03, King County, Washington",247,78,191,69,56,45
1500000US530330290041,530330290041,"Block Group 1, Census Tract 290.04, King County, Washington",721,90,315,87,406,90
1500000US530330290042,530330290042,"Block Group 2, Census Tract 290.04, King County, Washington",543,94,56,35,487,94
1500000US530330291011,530330291011,"Block Group 1, Census Tract 291.01, King County, Washington",461,78,286,71,175,63
1500000US530330291012,530330291012,"Block Group 2, Census Tract 291.01, King County, Washington",721,93,524,82,197,78
1500000US530330291021,530330291021,"Block Group 1, Census Tract 291.02, King County, Washington",459,137,373,127,86,57
1500000US530330291022,530330291022,"Block Group 2, Census Tract 291.02, King County, Washington",372,111,343,106,29,26
1500000US530330291023,530330291023,"Block Group 3, Census Tract 291.02, King County, Washington",530,126,241,77,289,132
1500000US530330292031,530330292031,"Block Group 1, Census Tract 292.03, King County, Washington",690,93,96,58,594,103
1500000US530330292032,530330292032,"Block Group 2, Census Tract 292.03, King County, Washington",513,93,148,48,365,93
1500000US530330292041,530330292041,"Block Group 1, Census Tract 292.04, King County, Washington",1020,154,297,96,723,157
1500000US530330292042,530330292042,"Block Group 2, Census Tract 292.04, King County, Washington",629,103,584,96,45,57
1500000US530330292043,530330292043,"Block Group 3, Census Tract 292.04, King County, Washington",368,81,286,88,82,74
1500000US530330292044,530330292044,"Block Group 4, Census Tract 292.04, King County, Washington",459,139,0,12,459,139
1500000US530330292051,530330292051,"Block Group 1, Census Tract 292.05, King County, Washington",943,111,740,102,203,86
1500000US530330292052,530330292052,"Block Group 2, Census Tract 292.05, King County, Washington",401,115,123,69,278,111
1500000US530330292053,530330292053,"Block Group 3, Census Tract 292.05, King County, Washington",704,140,347,109,357,124
1500000US530330292061,530330292061,"Block Group 1, Census Tract 292.06, King County, Washington",271,77,115,56,156,66
1500000US530330292062,530330292062,"Block Group 2, Census Tract 292.06, King County, Washington",1035,124,0,12,1035,124
1500000US530330292063,530330292063,"Block Group 3, Census Tract 292.06, King County, Washington",660,101,156,59,504,111
1500000US530330293031,530330293031,"Block Group 1, Census Tract 293.03, King County, Washington",348,92,260,102,88,62
1500000US530330293032,530330293032,"Block Group 2, Census Tract 293.03, King County, Washington",329,95,231,78,98,71
1500000US530330293033,530330293033,"Block Group 3, Census Tract 293.03, King County, Washington",1306,157,737,132,569,171
1500000US530330293034,530330293034,"Block Group 4, Census Tract 293.03, King County, Washington",483,101,347,85,136,98
1500000US530330293035,530330293035,"Block Group 5, Census Tract 293.03, King County, Washington",554,133,140,62,414,124
1500000US530330293041,530330293041,"Block Group 1, Census Tract 293.04, King County, Washington",408,86,330,79,78,56
1500000US530330293042,530330293042,"Block Group 2, Census Tract 293.04, King County, Washington",473,63,422,64,51,50
1500000US530330293043,530330293043,"Block Group 3, Census Tract 293.04, King County, Washington",583,90,262,74,321,71
1500000US530330293044,530330293044,"Block Group 4, Census Tract 293.04, King County, Washington",359,55,345,54,14,22
1500000US530330293051,530330293051,"Block Group 1, Census Tract 293.05, King County, Washington",309,75,274,76,35,27
1500000US530330293052,530330293052,"Block Group 2, Census Tract 293.05, King County, Washington",411,91,236,68,175,74
1500000US530330293053,530330293053,"Block Group 3, Census Tract 293.05, King County, Washington",387,72,287,66,100,47
1500000US530330293054,530330293054,"Block Group 4, Census Tract 293.05, King County, Washington",249,58,240,57,9,16
1500000US530330293061,530330293061,"Block Group 1, Census Tract 293.06, King County, Washington",767,83,530,90,237,93
1500000US530330293062,530330293062,"Block Group 2, Census Tract 293.06, King County, Washington",503,67,442,54,61,48
1500000US530330293071,530330293071,"Block Group 1, Census Tract 293.07, King County, Washington",302,66,233,63,69,46
1500000US530330293072,530330293072,"Block Group 2, Census Tract 293.07, King County, Washington",568,78,474,79,94,59
1500000US530330293073,530330293073,"Block Group 3, Census Tract 293.07, King County, Washington",442,72,367,77,75,49
1500000US530330294031,530330294031,"Block Group 1, Census Tract 294.03, King County, Washington",671,101,594,99,77,45
1500000US530330294032,530330294032,"Block Group 2, Census Tract 294.03, King County, Washington",393,73,343,75,50,54
1500000US530330294033,530330294033,"Block Group 3, Census Tract 294.03, King County, Washington",848,131,353,80,495,105
1500000US530330294051,530330294051,"Block Group 1, Census Tract 294.05, King County, Washington",410,81,320,71,90,57
1500000US530330294052,530330294052,"Block Group 2, Census Tract 294.05, King County, Washington",500,94,448,88,52,46
1500000US530330294053,530330294053,"Block Group 3, Census Tract 294.05, King County, Washington",243,58,203,45,40,42
1500000US530330294054,530330294054,"Block Group 4, Census Tract 294.05, King County, Washington",270,63,205,56,65,48
1500000US530330294055,530330294055,"Block Group 5, Census Tract 294.05, King County, Washington",314,58,286,59,28,25
1500000US530330294061,530330294061,"Block Group 1, Census Tract 294.06, King County, Washington",628,83,466,70,162,76
1500000US530330294062,530330294062,"Block Group 2, Census Tract 294.06, King County, Washington",988,95,770,99,218,112
1500000US530330294071,530330294071,"Block Group 1, Census Tract 294.07, King County, Washington",373,88,167,71,206,69
1500000US530330294072,530330294072,"Block Group 2, Census Tract 294.07, King County, Washington",792,106,344,70,448,107
1500000US530330294073,530330294073,"Block Group 3, Census Tract 294.07, King County, Washington",400,85,252,66,148,56
1500000US530330294081,530330294081,"Block Group 1, Census Tract 294.08, King County, Washington",332,71,279,72,53,32
1500000US530330294082,530330294082,"Block Group 2, Census Tract 294.08, King County, Washington",484,62,354,101,130,86
1500000US530330294083,530330294083,"Block Group 3, Census Tract 294.08, King County, Washington",784,105,108,37,676,101
1500000US530330295021,530330295021,"Block Group 1, Census Tract 295.02, King County, Washington",779,125,528,114,251,114
1500000US530330295022,530330295022,"Block Group 2, Census Tract 295.02, King County, Washington",458,91,405,89,53,49
1500000US530330295023,530330295023,"Block Group 3, Census Tract 295.02, King County, Washington",402,90,342,86,60,53
1500000US530330295024,530330295024,"Block Group 4, Census Tract 295.02, King County, Washington",434,93,368,79,66,48
1500000US530330295031,530330295031,"Block Group 1, Census Tract 295.03, King County, Washington",329,82,255,82,74,62
1500000US530330295032,530330295032,"Block Group 2, Census Tract 295.03, King County, Washington",851,187,147,75,704,175
1500000US530330295033,530330295033,"Block Group 3, Census Tract 295.03, King County, Washington",726,153,123,59,603,148
1500000US530330295034,530330295034,"Block Group 4, Census Tract 295.03, King County, Washington",254,87,131,57,123,77
1500000US530330295035,530330295035,"Block Group 5, Census Tract 295.03, King County, Washington",746,163,36,31,710,171
1500000US530330295041,530330295041,"Block Group 1, Census Tract 295.04, King County, Washington",534,144,112,74,422,142
1500000US530330295042,530330295042,"Block Group 2, Census Tract 295.04, King County, Washington",795,142,216,87,579,148
1500000US530330295043,530330295043,"Block Group 3, Census Tract 295.04, King County, Washington",842,144,359,72,483,141
1500000US530330296011,530330296011,"Block Group 1, Census Tract 296.01, King County, Washington",369,115,211,70,158,100
1500000US530330296012,530330296012,"Block Group 2, Census Tract 296.01, King County, Washington",360,77,313,84,47,46
1500000US530330296013,530330296013,"Block Group 3, Census Tract 296.01, King County, Washington",468,96,201,68,267,78
1500000US530330296014,530330296014,"Block Group 4, Census Tract 296.01, King County, Washington",297,82,282,82,15,23
1500000US530330296015,530330296015,"Block Group 5, Census Tract 296.01, King County, Washington",502,113,382,114,120,104
1500000US530330296021,530330296021,"Block Group 1, Census Tract 296.02, King County, Washington",407,62,407,62,0,12
1500000US530330296022,530330296022,"Block Group 2, Census Tract 296.02, King County, Washington",512,78,496,79,16,17
1500000US530330296023,530330296023,"Block Group 3, Census Tract 296.02, King County, Washington",933,88,793,96,140,73
1500000US530330297001,530330297001,"Block Group 1, Census Tract 297, King County, Washington",581,112,396,111,185,68
1500000US530330297002,530330297002,"Block Group 2, Census Tract 297, King County, Washington",591,116,374,105,217,95
1500000US530330297003,530330297003,"Block Group 3, Census Tract 297, King County, Washington",757,170,199,117,558,150
1500000US530330297004,530330297004,"Block Group 4, Census Tract 297, King County, Washington",400,114,198,77,202,123
1500000US530330297005,530330297005,"Block Group 5, Census Tract 297, King County, Washington",548,123,213,98,335,107
1500000US530330298011,530330298011,"Block Group 1, Census Tract 298.01, King County, Washington",435,85,360,88,75,56
1500000US530330298012,530330298012,"Block Group 2, Census Tract 298.01, King County, Washington",720,140,255,81,465,127
1500000US530330298013,530330298013,"Block Group 3, Census Tract 298.01, King County, Washington",486,124,320,94,166,91
1500000US530330298014,530330298014,"Block Group 4, Census Tract 298.01, King County, Washington",474,96,444,93,30,33
1500000US530330298015,530330298015,"Block Group 5, Census Tract 298.01, King County, Washington",852,164,0,12,852,164
1500000US530330298021,530330298021,"Block Group 1, Census Tract 298.02, King County, Washington",307,102,291,102,16,29
1500000US530330298022,530330298022,"Block Group 2, Census Tract 298.02, King County, Washington",377,109,275,91,102,93
1500000US530330298023,530330298023,"Block Group 3, Census Tract 298.02, King County, Washington",642,132,343,77,299,123
1500000US530330298024,530330298024,"Block Group 4, Census Tract 298.02, King County, Washington",306,98,249,90,57,65
1500000US530330298025,530330298025,"Block Group 5, Census Tract 298.02, King County, Washington",625,145,518,114,107,108
1500000US530330298026,530330298026,"Block Group 6, Census Tract 298.02, King County, Washington",627,126,613,130,14,23
1500000US530330299011,530330299011,"Block Group 1, Census Tract 299.01, King County, Washington",626,87,485,84,141,65
1500000US530330299012,530330299012,"Block Group 2, Census Tract 299.01, King County, Washington",400,80,361,78,39,31
1500000US530330299013,530330299013,"Block Group 3, Census Tract 299.01, King County, Washington",542,78,361,79,181,58
1500000US530330299021,530330299021,"Block Group 1, Census Tract 299.02, King County, Washington",389,77,362,77,27,25
1500000US530330299022,530330299022,"Block Group 2, Census Tract 299.02, King County, Washington",410,64,334,80,76,53
1500000US530330299023,530330299023,"Block Group 3, Census Tract 299.02, King County, Washington",624,77,551,74,73,44
1500000US530330300031,530330300031,"Block Group 1, Census Tract 300.03, King County, Washington",405,99,358,92,47,47
1500000US530330300032,530330300032,"Block Group 2, Census Tract 300.03, King County, Washington",676,140,552,124,124,96
1500000US530330300033,530330300033,"Block Group 3, Census Tract 300.03, King County, Washington",425,99,265,101,160,101
1500000US530330300034,530330300034,"Block Group 4, Census Tract 300.03, King County, Washington",313,83,272,79,41,46
1500000US530330300035,530330300035,"Block Group 5, Census Tract 300.03, King County, Washington",582,153,24,41,558,155
1500000US530330300041,530330300041,"Block Group 1, Census Tract 300.04, King County, Washington",453,149,251,94,202,124
1500000US530330300042,530330300042,"Block Group 2, Census Tract 300.04, King County, Washington",714,193,43,32,671,196
1500000US530330300043,530330300043,"Block Group 3, Census Tract 300.04, King County, Washington",467,145,90,67,377,143
1500000US530330300044,530330300044,"Block Group 4, Census Tract 300.04, King County, Washington",327,104,306,107,21,31
1500000US530330300045,530330300045,"Block Group 5, Census Tract 300.04, King County, Washington",536,162,84,44,452,162
1500000US530330300046,530330300046,"Block Group 6, Census Tract 300.04, King County, Washington",583,166,195,77,388,160
1500000US530330300051,530330300051,"Block Group 1, Census Tract 300.05, King County, Washington",517,83,309,57,208,82
1500000US530330300052,530330300052,"Block Group 2, Census Tract 300.05, King County, Washington",551,78,494,82,57,50
1500000US530330300053,530330300053,"Block Group 3, Census Tract 300.05, King County, Washington",769,113,343,90,426,115
1500000US530330300061,530330300061,"Block Group 1, Census Tract 300.06, King County, Washington",552,109,183,59,369,110
1500000US530330300062,530330300062,"Block Group 2, Census Tract 300.06, King County, Washington",1095,108,82,41,1013,110
1500000US530330301001,530330301001,"Block Group 1, Census Tract 301, King County, Washington",327,87,307,89,20,33
1500000US530330301002,530330301002,"Block Group 2, Census Tract 301, King County, Washington",431,96,360,89,71,93
1500000US530330301003,530330301003,"Block Group 3, Census Tract 301, King County, Washington",612,132,572,124,40,41
1500000US530330301004,530330301004,"Block Group 4, Census Tract 301, King County, Washington",386,116,370,114,16,28
1500000US530330301005,530330301005,"Block Group 5, Census Tract 301, King County, Washington",418,145,27,32,391,144
1500000US530330301006,530330301006,"Block Group 6, Census Tract 301, King County, Washington",378,74,360,76,18,28
1500000US530330301007,530330301007,"Block Group 7, Census Tract 301, King County, Washington",404,102,404,102,0,12
1500000US530330302011,530330302011,"Block Group 1, Census Tract 302.01, King County, Washington",332,90,205,44,127,79
1500000US530330302012,530330302012,"Block Group 2, Census Tract 302.01, King County, Washington",560,115,134,47,426,104
1500000US530330302013,530330302013,"Block Group 3, Census Tract 302.01, King County, Washington",496,102,415,108,81,64
1500000US530330302014,530330302014,"Block Group 4, Census Tract 302.01, King County, Washington",708,111,501,116,207,98
1500000US530330302021,530330302021,"Block Group 1, Census Tract 302.02, King County, Washington",321,94,321,94,0,12
1500000US530330302022,530330302022,"Block Group 2, Census Tract 302.02, King County, Washington",563,129,429,128,134,86
1500000US530330302023,530330302023,"Block Group 3, Census Tract 302.02, King County, Washington",245,95,164,101,81,52
1500000US530330302024,530330302024,"Block Group 4, Census Tract 302.02, King County, Washington",639,144,231,99,408,125
1500000US530330302025,530330302025,"Block Group 5, Census Tract 302.02, King County, Washington",603,166,240,93,363,154
1500000US530330303041,530330303041,"Block Group 1, Census Tract 303.04, King County, Washington",570,84,538,80,32,32
1500000US530330303042,530330303042,"Block Group 2, Census Tract 303.04, King County, Washington",528,84,331,69,197,85
1500000US530330303051,530330303051,"Block Group 1, Census Tract 303.05, King County, Washington",753,127,443,95,310,112
1500000US530330303052,530330303052,"Block Group 2, Census Tract 303.05, King County, Washington",763,155,670,152,93,81
1500000US530330303053,530330303053,"Block Group 3, Census Tract 303.05, King County, Washington",588,110,583,114,5,35
1500000US530330303061,530330303061,"Block Group 1, Census Tract 303.06, King County, Washington",479,75,361,75,118,52
1500000US530330303062,530330303062,"Block Group 2, Census Tract 303.06, King County, Washington",405,75,354,69,51,63
1500000US530330303063,530330303063,"Block Group 3, Census Tract 303.06, King County, Washington",699,97,555,89,144,50
1500000US530330303064,530330303064,"Block Group 4, Census Tract 303.06, King County, Washington",362,77,335,73,27,26
1500000US530330303081,530330303081,"Block Group 1, Census Tract 303.08, King County, Washington",242,82,242,82,0,12
1500000US530330303082,530330303082,"Block Group 2, Census Tract 303.08, King County, Washington",670,129,282,95,388,107
1500000US530330303083,530330303083,"Block Group 3, Census Tract 303.08, King County, Washington",621,122,562,123,59,67
1500000US530330303084,530330303084,"Block Group 4, Census Tract 303.08, King County, Washington",764,139,124,69,640,148
1500000US530330303091,530330303091,"Block Group 1, Census Tract 303.09, King County, Washington",373,94,262,93,111,70
1500000US530330303092,530330303092,"Block Group 2, Census Tract 303.09, King County, Washington",702,166,83,60,619,164
1500000US530330303093,530330303093,"Block Group 3, Census Tract 303.09, King County, Washington",489,120,85,69,404,117
1500000US530330303094,530330303094,"Block Group 4, Census Tract 303.09, King County, Washington",846,146,442,128,404,136
1500000US530330303101,530330303101,"Block Group 1, Census Tract 303.10, King County, Washington",256,65,218,58,38,37
1500000US530330303102,530330303102,"Block Group 2, Census Tract 303.10, King County, Washington",301,67,242,64,59,40
1500000US530330303103,530330303103,"Block Group 3, Census Tract 303.10, King County, Washington",499,89,443,79,56,49
1500000US530330303104,530330303104,"Block Group 4, Census Tract 303.10, King County, Washington",922,111,185,60,737,103
1500000US530330303111,530330303111,"Block Group 1, Census Tract 303.11, King County, Washington",413,76,322,73,91,68
1500000US530330303112,530330303112,"Block Group 2, Census Tract 303.11, King County, Washington",570,105,310,82,260,101
1500000US530330303113,530330303113,"Block Group 3, Census Tract 303.11, King County, Washington",446,70,400,69,46,32
1500000US530330303114,530330303114,"Block Group 4, Census Tract 303.11, King County, Washington",279,82,240,85,39,34
1500000US530330303121,530330303121,"Block Group 1, Census Tract 303.12, King County, Washington",576,108,69,43,507,101
1500000US530330303122,530330303122,"Block Group 2, Census Tract 303.12, King County, Washington",548,112,288,78,260,87
1500000US530330303123,530330303123,"Block Group 3, Census Tract 303.12, King County, Washington",319,69,300,68,19,26
1500000US530330303124,530330303124,"Block Group 4, Census Tract 303.12, King County, Washington",349,82,270,58,79,71
1500000US530330303131,530330303131,"Block Group 1, Census Tract 303.13, King County, Washington",749,122,367,95,382,121
1500000US530330303132,530330303132,"Block Group 2, Census Tract 303.13, King County, Washington",866,131,309,86,557,123
1500000US530330303141,530330303141,"Block Group 1, Census Tract 303.14, King County, Washington",828,127,126,49,702,136
1500000US530330303142,530330303142,"Block Group 2, Census Tract 303.14, King County, Washington",392,78,281,64,111,71
1500000US530330303143,530330303143,"Block Group 3, Census Tract 303.14, King County, Washington",718,129,321,86,397,119
1500000US530330304011,530330304011,"Block Group 1, Census Tract 304.01, King County, Washington",865,142,494,125,371,142
1500000US530330304012,530330304012,"Block Group 2, Census Tract 304.01, King County, Washington",612,125,501,107,111,93
1500000US530330304013,530330304013,"Block Group 3, Census Tract 304.01, King County, Washington",533,132,416,113,117,100
1500000US530330304014,530330304014,"Block Group 4, Census Tract 304.01, King County, Washington",413,122,313,115,100,77
1500000US530330304015,530330304015,"Block Group 5, Census Tract 304.01, King County, Washington",700,145,298,104,402,143
1500000US530330304031,530330304031,"Block Group 1, Census Tract 304.03, King County, Washington",595,86,522,79,73,55
1500000US530330304032,530330304032,"Block Group 2, Census Tract 304.03, King County, Washington",415,69,366,63,49,49
1500000US530330304033,530330304033,"Block Group 3, Census Tract 304.03, King County, Washington",647,98,610,94,37,35
1500000US530330304041,530330304041,"Block Group 1, Census Tract 304.04, King County, Washington",653,68,609,77,44,41
1500000US530330304042,530330304042,"Block Group 2, Census Tract 304.04, King County, Washington",484,68,384,69,100,57
1500000US530330304043,530330304043,"Block Group 3, Census Tract 304.04, King County, Washington",480,79,431,80,49,43
1500000US530330305011,530330305011,"Block Group 1, Census Tract 305.01, King County, Washington",396,60,99,30,297,64
1500000US530330305012,530330305012,"Block Group 2, Census Tract 305.01, King County, Washington",535,55,37,30,498,53
1500000US530330305031,530330305031,"Block Group 1, Census Tract 305.03, King County, Washington",909,153,107,62,802,158
1500000US530330305032,530330305032,"Block Group 2, Census Tract 305.03, King County, Washington",1182,166,776,128,406,129
1500000US530330305041,530330305041,"Block Group 1, Census Tract 305.04, King County, Washington",287,77,90,33,197,75
1500000US530330305042,530330305042,"Block Group 2, Census Tract 305.04, King County, Washington",451,86,230,64,221,63
1500000US530330305043,530330305043,"Block Group 3, Census Tract 305.04, King County, Washington",450,95,100,41,350,105
1500000US530330305044,530330305044,"Block Group 4, Census Tract 305.04, King County, Washington",670,92,485,73,185,81
1500000US530330306001,530330306001,"Block Group 1, Census Tract 306, King County, Washington",421,91,302,92,119,73
1500000US530330306002,530330306002,"Block Group 2, Census Tract 306, King County, Washington",594,118,354,110,240,117
1500000US530330306003,530330306003,"Block Group 3, Census Tract 306, King County, Washington",602,102,340,95,262,99
1500000US530330306004,530330306004,"Block Group 4, Census Tract 306, King County, Washington",427,98,136,81,291,109
1500000US530330307001,530330307001,"Block Group 1, Census Tract 307, King County, Washington",466,88,171,69,295,91
1500000US530330307002,530330307002,"Block Group 2, Census Tract 307, King County, Washington",553,97,252,63,301,95
1500000US530330307003,530330307003,"Block Group 3, Census Tract 307, King County, Washington",470,102,180,62,290,90
1500000US530330308011,530330308011,"Block Group 1, Census Tract 308.01, King County, Washington",583,115,350,114,233,97
1500000US530330308012,530330308012,"Block Group 2, Census Tract 308.01, King County, Washington",586,124,125,76,461,125
1500000US530330308013,530330308013,"Block Group 3, Census Tract 308.01, King County, Washington",1163,151,855,143,308,115
1500000US530330308021,530330308021,"Block Group 1, Census Tract 308.02, King County, Washington",440,88,111,43,329,90
1500000US530330308022,530330308022,"Block Group 2, Census Tract 308.02, King County, Washington",547,100,332,86,215,64
1500000US530330308023,530330308023,"Block Group 3, Census Tract 308.02, King County, Washington",413,107,249,64,164,84
1500000US530330309011,530330309011,"Block Group 1, Census Tract 309.01, King County, Washington",665,83,548,72,117,63
1500000US530330309012,530330309012,"Block Group 2, Census Tract 309.01, King County, Washington",524,102,341,67,183,86
1500000US530330309021,530330309021,"Block Group 1, Census Tract 309.02, King County, Washington",872,151,501,130,371,134
1500000US530330309022,530330309022,"Block Group 2, Census Tract 309.02, King County, Washington",508,97,358,96,150,75
1500000US530330309023,530330309023,"Block Group 3, Census Tract 309.02, King County, Washington",741,142,166,63,575,141
1500000US530330310001,530330310001,"Block Group 1, Census Tract 310, King County, Washington",913,84,861,106,52,48
1500000US530330310002,530330310002,"Block Group 2, Census Tract 310, King County, Washington",557,81,349,80,208,75
1500000US530330311001,530330311001,"Block Group 1, Census Tract 311, King County, Washington",431,92,202,50,229,105
1500000US530330311002,530330311002,"Block Group 2, Census Tract 311, King County, Washington",577,92,540,92,37,32
1500000US530330311003,530330311003,"Block Group 3, Census Tract 311, King County, Washington",708,85,371,65,337,51
1500000US530330311004,530330311004,"Block Group 4, Census Tract 311, King County, Washington",523,102,102,21,421,104
1500000US530330311005,530330311005,"Block Group 5, Census Tract 311, King County, Washington",372,82,244,45,128,84
1500000US530330312021,530330312021,"Block Group 1, Census Tract 312.02, King County, Washington",534,115,396,87,138,107
1500000US530330312022,530330312022,"Block Group 2, Census Tract 312.02, King County, Washington",341,76,148,62,193,64
1500000US530330312023,530330312023,"Block Group 3, Census Tract 312.02, King County, Washington",444,82,444,82,0,12
1500000US530330312024,530330312024,"Block Group 4, Census Tract 312.02, King County, Washington",560,108,470,111,90,64
1500000US530330312025,530330312025,"Block Group 5, Census Tract 312.02, King County, Washington",376,98,180,57,196,86
1500000US530330312041,530330312041,"Block Group 1, Census Tract 312.04, King County, Washington",436,116,267,83,169,107
1500000US530330312042,530330312042,"Block Group 2, Census Tract 312.04, King County, Washington",423,86,374,88,49,77
1500000US530330312043,530330312043,"Block Group 3, Census Tract 312.04, King County, Washington",524,86,498,91,26,30
1500000US530330312044,530330312044,"Block Group 4, Census Tract 312.04, King County, Washington",479,121,366,123,113,115
1500000US530330312045,530330312045,"Block Group 5, Census Tract 312.04, King County, Washington",447,99,384,91,63,77
1500000US530330312051,530330312051,"Block Group 1, Census Tract 312.05, King County, Washington",864,147,510,126,354,120
1500000US530330312052,530330312052,"Block Group 2, Census Tract 312.05, King County, Washington",685,147,553,135,132,84
1500000US530330312053,530330312053,"Block Group 3, Census Tract 312.05, King County, Washington",647,123,466,105,181,121
1500000US530330312061,530330312061,"Block Group 1, Census Tract 312.06, King County, Washington",386,82,210,62,176,63
1500000US530330312062,530330312062,"Block Group 2, Census Tract 312.06, King County, Washington",613,96,377,83,236,86
1500000US530330312063,530330312063,"Block Group 3, Census Tract 312.06, King County, Washington",763,98,430,84,333,68
1500000US530330313011,530330313011,"Block Group 1, Census Tract 313.01, King County, Washington",493,61,327,55,166,68
1500000US530330313012,530330313012,"Block Group 2, Census Tract 313.01, King County, Washington",514,57,421,59,93,48
1500000US530330313021,530330313021,"Block Group 1, Census Tract 313.02, King County, Washington",382,63,334,63,48,32
1500000US530330313022,530330313022,"Block Group 2, Census Tract 313.02, King County, Washington",422,79,310,64,112,57
1500000US530330313023,530330313023,"Block Group 3, Census Tract 313.02, King County, Washington",407,66,362,69,45,39
1500000US530330313024,530330313024,"Block Group 4, Census Tract 313.02, King County, Washington",426,87,78,40,348,86
1500000US530330314001,530330314001,"Block Group 1, Census Tract 314, King County, Washington",435,134,159,103,276,120
1500000US530330314002,530330314002,"Block Group 2, Census Tract 314, King County, Washington",612,162,310,87,302,148
1500000US530330314003,530330314003,"Block Group 3, Census Tract 314, King County, Washington",528,100,471,103,57,50
1500000US530330314004,530330314004,"Block Group 4, Census Tract 314, King County, Washington",409,104,192,69,217,129
1500000US530330314005,530330314005,"Block Group 5, Census Tract 314, King County, Washington",363,98,169,62,194,98
1500000US530330315011,530330315011,"Block Group 1, Census Tract 315.01, King County, Washington",424,95,355,84,69,72
1500000US530330315012,530330315012,"Block Group 2, Census Tract 315.01, King County, Washington",562,95,427,98,135,84
1500000US530330315013,530330315013,"Block Group 3, Census Tract 315.01, King County, Washington",491,112,282,70,209,106
1500000US530330315021,530330315021,"Block Group 1, Census Tract 315.02, King County, Washington",448,90,440,92,8,13
1500000US530330315022,530330315022,"Block Group 2, Census Tract 315.02, King County, Washington",527,74,484,75,43,27
1500000US530330315023,530330315023,"Block Group 3, Census Tract 315.02, King County, Washington",695,86,470,87,225,87
1500000US530330316011,530330316011,"Block Group 1, Census Tract 316.01, King County, Washington",746,71,713,75,33,29
1500000US530330316012,530330316012,"Block Group 2, Census Tract 316.01, King County, Washington",723,75,678,83,45,32
1500000US530330316013,530330316013,"Block Group 3, Census Tract 316.01, King County, Washington",531,74,470,86,61,57
1500000US530330316031,530330316031,"Block Group 1, Census Tract 316.03, King County, Washington",567,83,507,84,60,35
1500000US530330316032,530330316032,"Block Group 2, Census Tract 316.03, King County, Washington",474,103,362,100,112,81
1500000US530330316033,530330316033,"Block Group 3, Census Tract 316.03, King County, Washington",565,116,506,118,59,37
1500000US530330316034,530330316034,"Block Group 4, Census Tract 316.03, King County, Washington",501,76,427,80,74,48
1500000US530330316041,530330316041,"Block Group 1, Census Tract 316.04, King County, Washington",945,99,849,114,96,60
1500000US530330316042,530330316042,"Block Group 2, Census Tract 316.04, King County, Washington",324,68,278,63,46,38
1500000US530330316043,530330316043,"Block Group 3, Census Tract 316.04, King County, Washington",507,87,406,86,101,62
1500000US530330316051,530330316051,"Block Group 1, Census Tract 316.05, King County, Washington",462,80,413,76,49,53
1500000US530330316052,530330316052,"Block Group 2, Census Tract 316.05, King County, Washington",431,78,385,79,46,35
1500000US530330316053,530330316053,"Block Group 3, Census Tract 316.05, King County, Washington",403,81,370,79,33,27
1500000US530330317031,530330317031,"Block Group 1, Census Tract 317.03, King County, Washington",340,72,340,72,0,12
1500000US530330317032,530330317032,"Block Group 2, Census Tract 317.03, King County, Washington",482,105,423,89,59,62
1500000US530330317033,530330317033,"Block Group 3, Census Tract 317.03, King County, Washington",625,101,499,121,126,86
1500000US530330317034,530330317034,"Block Group 4, Census Tract 317.03, King County, Washington",454,108,230,103,224,87
1500000US530330317035,530330317035,"Block Group 5, Census Tract 317.03, King County, Washington",735,128,723,127,12,20
1500000US530330317041,530330317041,"Block Group 1, Census Tract 317.04, King County, Washington",332,60,284,58,48,32
1500000US530330317042,530330317042,"Block Group 2, Census Tract 317.04, King County, Washington",578,95,273,73,305,100
1500000US530330317043,530330317043,"Block Group 3, Census Tract 317.04, King County, Washington",810,113,667,114,143,72
1500000US530330317051,530330317051,"Block Group 1, Census Tract 317.05, King County, Washington",435,70,378,70,57,46
1500000US530330317052,530330317052,"Block Group 2, Census Tract 317.05, King County, Washington",355,77,316,72,39,51
1500000US530330317053,530330317053,"Block Group 3, Census Tract 317.05, King County, Washington",513,101,432,83,81,59
1500000US530330317061,530330317061,"Block Group 1, Census Tract 317.06, King County, Washington",429,102,392,105,37,41
1500000US530330317062,530330317062,"Block Group 2, Census Tract 317.06, King County, Washington",975,123,343,117,632,127
1500000US530330317063,530330317063,"Block Group 3, Census Tract 317.06, King County, Washington",481,92,396,93,85,46
1500000US530330317064,530330317064,"Block Group 4, Census Tract 317.06, King County, Washington",647,112,522,114,125,87
1500000US530330318001,530330318001,"Block Group 1, Census Tract 318, King County, Washington",650,74,590,79,60,61
1500000US530330318002,530330318002,"Block Group 2, Census Tract 318, King County, Washington",485,68,424,69,61,45
1500000US530330318003,530330318003,"Block Group 3, Census Tract 318, King County, Washington",571,67,523,70,48,34
1500000US530330319031,530330319031,"Block Group 1, Census Tract 319.03, King County, Washington",620,80,556,86,64,56
1500000US530330319032,530330319032,"Block Group 2, Census Tract 319.03, King County, Washington",656,94,532,93,124,73
1500000US530330319033,530330319033,"Block Group 3, Census Tract 319.03, King County, Washington",334,70,301,69,33,29
1500000US530330319034,530330319034,"Block Group 4, Census Tract 319.03, King County, Washington",383,87,327,78,56,51
1500000US530330319035,530330319035,"Block Group 5, Census Tract 319.03, King County, Washington",404,88,311,75,93,60
1500000US530330319041,530330319041,"Block Group 1, Census Tract 319.04, King County, Washington",636,78,546,84,90,48
1500000US530330319042,530330319042,"Block Group 2, Census Tract 319.04, King County, Washington",304,64,272,71,32,39
1500000US530330319043,530330319043,"Block Group 3, Census Tract 319.04, King County, Washington",379,69,324,64,55,51
1500000US530330319061,530330319061,"Block Group 1, Census Tract 319.06, King County, Washington",609,76,553,83,56,49
1500000US530330319062,530330319062,"Block Group 2, Census Tract 319.06, King County, Washington",783,80,718,88,65,40
1500000US530330319071,530330319071,"Block Group 1, Census Tract 319.07, King County, Washington",253,57,253,57,0,12
1500000US530330319072,530330319072,"Block Group 2, Census Tract 319.07, King County, Washington",306,77,295,82,11,19
1500000US530330319073,530330319073,"Block Group 3, Census Tract 319.07, King County, Washington",991,161,714,149,277,119
1500000US530330319074,530330319074,"Block Group 4, Census Tract 319.07, King County, Washington",845,123,747,119,98,97
1500000US530330319075,530330319075,"Block Group 5, Census Tract 319.07, King County, Washington",380,97,310,82,70,68
1500000US530330319081,530330319081,"Block Group 1, Census Tract 319.08, King County, Washington",690,110,460,84,230,95
1500000US530330319082,530330319082,"Block Group 2, Census Tract 319.08, King County, Washington",740,112,124,62,616,118
1500000US530330319083,530330319083,"Block Group 3, Census Tract 319.08, King County, Washington",458,99,224,60,234,98
1500000US530330319091,530330319091,"Block Group 1, Census Tract 319.09, King County, Washington",723,67,487,59,236,70
1500000US530330319092,530330319092,"Block Group 2, Census Tract 319.09, King County, Washington",438,53,395,61,43,42
1500000US530330320021,530330320021,"Block Group 1, Census Tract 320.02, King County, Washington",656,82,549,98,107,64
1500000US530330320022,530330320022,"Block Group 2, Census Tract 320.02, King County, Washington",580,79,466,68,114,67
1500000US530330320031,530330320031,"Block Group 1, Census Tract 320.03, King County, Washington",624,90,569,91,55,32
1500000US530330320032,530330320032,"Block Group 2, Census Tract 320.03, King County, Washington",499,92,450,99,49,35
1500000US530330320033,530330320033,"Block Group 3, Census Tract 320.03, King County, Washington",362,79,344,78,18,20
1500000US530330320034,530330320034,"Block Group 4, Census Tract 320.03, King County, Washington",440,104,430,104,10,16
1500000US530330320051,530330320051,"Block Group 1, Census Tract 320.05, King County, Washington",288,80,237,91,51,51
1500000US530330320052,530330320052,"Block Group 2, Census Tract 320.05, King County, Washington",433,147,433,147,0,12
1500000US530330320053,530330320053,"Block Group 3, Census Tract 320.05, King County, Washington",408,97,326,95,82,53
1500000US530330320054,530330320054,"Block Group 4, Census Tract 320.05, King County, Washington",466,111,389,107,77,65
1500000US530330320055,530330320055,"Block Group 5, Census Tract 320.05, King County, Washington",542,133,490,130,52,48
1500000US530330320056,530330320056,"Block Group 6, Census Tract 320.05, King County, Washington",268,60,233,61,35,41
1500000US530330320061,530330320061,"Block Group 1, Census Tract 320.06, King County, Washington",440,70,413,73,27,25
1500000US530330320062,530330320062,"Block Group 2, Census Tract 320.06, King County, Washington",815,106,631,118,184,73
1500000US530330320063,530330320063,"Block Group 3, Census Tract 320.06, King County, Washington",639,96,511,95,128,73
1500000US530330320071,530330320071,"Block Group 1, Census Tract 320.07, King County, Washington",421,83,405,86,16,23
1500000US530330320072,530330320072,"Block Group 2, Census Tract 320.07, King County, Washington",510,82,489,84,21,24
1500000US530330320073,530330320073,"Block Group 3, Census Tract 320.07, King County, Washington",402,65,221,69,181,53
1500000US530330320081,530330320081,"Block Group 1, Census Tract 320.08, King County, Washington",498,78,424,70,74,63
1500000US530330320082,530330320082,"Block Group 2, Census Tract 320.08, King County, Washington",578,95,462,95,116,76
1500000US530330320083,530330320083,"Block Group 3, Census Tract 320.08, King County, Washington",435,87,428,87,7,11
1500000US530330320101,530330320101,"Block Group 1, Census Tract 320.10, King County, Washington",602,108,294,89,308,92
1500000US530330320102,530330320102,"Block Group 2, Census Tract 320.10, King County, Washington",441,77,391,83,50,36
1500000US530330320103,530330320103,"Block Group 3, Census Tract 320.10, King County, Washington",471,91,471,91,0,12
1500000US530330320104,530330320104,"Block Group 4, Census Tract 320.10, King County, Washington",588,99,513,89,75,66
1500000US530330320111,530330320111,"Block Group 1, Census Tract 320.11, King County, Washington",696,89,570,92,126,76
1500000US530330320112,530330320112,"Block Group 2, Census Tract 320.11, King County, Washington",736,98,650,95,86,53
1500000US530330321021,530330321021,"Block Group 1, Census Tract 321.02, King County, Washington",462,69,414,76,48,33
1500000US530330321022,530330321022,"Block Group 2, Census Tract 321.02, King County, Washington",315,73,269,67,46,48
1500000US530330321023,530330321023,"Block Group 3, Census Tract 321.02, King County, Washington",563,74,490,75,73,60
1500000US530330321024,530330321024,"Block Group 4, Census Tract 321.02, King County, Washington",517,62,490,55,27,44
1500000US530330321031,530330321031,"Block Group 1, Census Tract 321.03, King County, Washington",346,91,170,66,176,96
1500000US530330321032,530330321032,"Block Group 2, Census Tract 321.03, King County, Washington",499,88,194,67,305,104
1500000US530330321033,530330321033,"Block Group 3, Census Tract 321.03, King County, Washington",713,133,182,70,531,146
1500000US530330321034,530330321034,"Block Group 4, Census Tract 321.03, King County, Washington",501,96,389,89,112,57
1500000US530330321041,530330321041,"Block Group 1, Census Tract 321.04, King County, Washington",858,145,771,143,87,53
1500000US530330321042,530330321042,"Block Group 2, Census Tract 321.04, King County, Washington",948,170,504,134,444,157
1500000US530330321043,530330321043,"Block Group 3, Census Tract 321.04, King County, Washington",692,131,287,81,405,144
1500000US530330322031,530330322031,"Block Group 1, Census Tract 322.03, King County, Washington",737,101,552,97,185,104
1500000US530330322032,530330322032,"Block Group 2, Census Tract 322.03, King County, Washington",539,92,470,97,69,68
1500000US530330322033,530330322033,"Block Group 3, Census Tract 322.03, King County, Washington",843,123,831,127,12,19
1500000US530330322034,530330322034,"Block Group 4, Census Tract 322.03, King County, Washington",430,85,344,84,86,72
1500000US530330322071,530330322071,"Block Group 1, Census Tract 322.07, King County, Washington",414,55,352,65,62,39
1500000US530330322072,530330322072,"Block Group 2, Census Tract 322.07, King County, Washington",352,63,319,59,33,37
1500000US530330322073,530330322073,"Block Group 3, Census Tract 322.07, King County, Washington",461,71,434,67,27,36
1500000US530330322081,530330322081,"Block Group 1, Census Tract 322.08, King County, Washington",722,129,637,128,85,62
1500000US530330322082,530330322082,"Block Group 2, Census Tract 322.08, King County, Washington",643,115,519,108,124,81
1500000US530330322083,530330322083,"Block Group 3, Census Tract 322.08, King County, Washington",926,127,317,82,609,128
1500000US530330322084,530330322084,"Block Group 4, Census Tract 322.08, King County, Washington",877,141,329,95,548,142
1500000US530330322085,530330322085,"Block Group 5, Census Tract 322.08, King County, Washington",923,123,642,84,281,100
1500000US530330322101,530330322101,"Block Group 1, Census Tract 322.10, King County, Washington",573,159,558,160,15,28
1500000US530330322102,530330322102,"Block Group 2, Census Tract 322.10, King County, Washington",1819,203,1452,228,367,124
1500000US530330322103,530330322103,"Block Group 3, Census Tract 322.10, King County, Washington",2314,244,1280,194,1034,252
1500000US530330322111,530330322111,"Block Group 1, Census Tract 322.11, King County, Washington",584,62,423,65,161,52
1500000US530330322112,530330322112,"Block Group 2, Census Tract 322.11, King County, Washington",647,70,533,74,114,67
1500000US530330322113,530330322113,"Block Group 3, Census Tract 322.11, King County, Washington",461,57,370,58,91,54
1500000US530330322121,530330322121,"Block Group 1, Census Tract 322.12, King County, Washington",867,115,697,108,170,64
1500000US530330322122,530330322122,"Block Group 2, Census Tract 322.12, King County, Washington",371,95,307,98,64,47
1500000US530330322123,530330322123,"Block Group 3, Census Tract 322.12, King County, Washington",479,81,447,80,32,37
1500000US530330322124,530330322124,"Block Group 4, Census Tract 322.12, King County, Washington",1100,138,786,123,314,109
1500000US530330322131,530330322131,"Block Group 1, Census Tract 322.13, King County, Washington",378,56,339,57,39,37
1500000US530330322132,530330322132,"Block Group 2, Census Tract 322.13, King County, Washington",366,49,360,52,6,10
1500000US530330322133,530330322133,"Block Group 3, Census Tract 322.13, King County, Washington",752,62,691,65,61,54
1500000US530330322141,530330322141,"Block Group 1, Census Tract 322.14, King County, Washington",562,62,507,64,55,36
1500000US530330322142,530330322142,"Block Group 2, Census Tract 322.14, King County, Washington",880,68,782,77,98,55
1500000US530330322143,530330322143,"Block Group 3, Census Tract 322.14, King County, Washington",559,53,478,62,81,41
1500000US530330322151,530330322151,"Block Group 1, Census Tract 322.15, King County, Washington",579,80,507,82,72,55
1500000US530330322152,530330322152,"Block Group 2, Census Tract 322.15, King County, Washington",884,80,842,77,42,30
1500000US530330323071,530330323071,"Block Group 1, Census Tract 323.07, King County, Washington",606,71,592,74,14,21
1500000US530330323072,530330323072,"Block Group 2, Census Tract 323.07, King County, Washington",372,73,318,67,54,51
1500000US530330323073,530330323073,"Block Group 3, Census Tract 323.07, King County, Washington",528,125,452,108,76,94
1500000US530330323074,530330323074,"Block Group 4, Census Tract 323.07, King County, Washington",421,103,354,83,67,81
1500000US530330323075,530330323075,"Block Group 5, Census Tract 323.07, King County, Washington",376,104,342,104,34,39
1500000US530330323091,530330323091,"Block Group 1, Census Tract 323.09, King County, Washington",810,143,50,48,760,142
1500000US530330323092,530330323092,"Block Group 2, Census Tract 323.09, King County, Washington",1878,192,119,70,1759,200
1500000US530330323093,530330323093,"Block Group 3, Census Tract 323.09, King County, Washington",667,89,451,93,216,73
1500000US530330323111,530330323111,"Block Group 1, Census Tract 323.11, King County, Washington",426,67,415,71,11,16
1500000US530330323112,530330323112,"Block Group 2, Census Tract 323.11, King County, Washington",496,110,466,105,30,44
1500000US530330323113,530330323113,"Block Group 3, Census Tract 323.11, King County, Washington",310,59,310,59,0,12
1500000US530330323114,530330323114,"Block Group 4, Census Tract 323.11, King County, Washington",517,90,496,87,21,35
1500000US530330323115,530330323115,"Block Group 5, Census Tract 323.11, King County, Washington",380,113,289,87,91,107
1500000US530330323131,530330323131,"Block Group 1, Census Tract 323.13, King County, Washington",293,77,253,72,40,33
1500000US530330323132,530330323132,"Block Group 2, Census Tract 323.13, King County, Washington",568,88,428,82,140,63
1500000US530330323133,530330323133,"Block Group 3, Census Tract 323.13, King County, Washington",239,59,223,61,16,21
1500000US530330323134,530330323134,"Block Group 4, Census Tract 323.13, King County, Washington",1232,121,113,59,1119,121
1500000US530330323151,530330323151,"Block Group 1, Census Tract 323.15, King County, Washington",758,94,607,78,151,76
1500000US530330323152,530330323152,"Block Group 2, Census Tract 323.15, King County, Washington",610,105,505,97,105,65
1500000US530330323153,530330323153,"Block Group 3, Census Tract 323.15, King County, Washington",658,96,588,98,70,53
1500000US530330323161,530330323161,"Block Group 1, Census Tract 323.16, King County, Washington",280,48,213,51,67,58
1500000US530330323162,530330323162,"Block Group 2, Census Tract 323.16, King County, Washington",539,64,510,66,29,25
1500000US530330323163,530330323163,"Block Group 3, Census Tract 323.16, King County, Washington",636,78,535,82,101,63
1500000US530330323164,530330323164,"Block Group 4, Census Tract 323.16, King County, Washington",409,67,373,69,36,29
1500000US530330323171,530330323171,"Block Group 1, Census Tract 323.17, King County, Washington",531,83,509,84,22,31
1500000US530330323172,530330323172,"Block Group 2, Census Tract 323.17, King County, Washington",479,73,462,78,17,25
1500000US530330323173,530330323173,"Block Group 3, Census Tract 323.17, King County, Washington",459,71,237,54,222,75
1500000US530330323174,530330323174,"Block Group 4, Census Tract 323.17, King County, Washington",315,71,304,70,11,15
1500000US530330323175,530330323175,"Block Group 5, Census Tract 323.17, King County, Washington",371,63,316,67,55,59
1500000US530330323181,530330323181,"Block Group 1, Census Tract 323.18, King County, Washington",742,61,621,62,121,74
1500000US530330323182,530330323182,"Block Group 2, Census Tract 323.18, King County, Washington",390,52,378,53,12,18
1500000US530330323183,530330323183,"Block Group 3, Census Tract 323.18, King County, Washington",279,48,260,50,19,15
1500000US530330323184,530330323184,"Block Group 4, Census Tract 323.18, King County, Washington",568,76,511,79,57,30
1500000US530330323191,530330323191,"Block Group 1, Census Tract 323.19, King County, Washington",219,64,219,64,0,12
1500000US530330323192,530330323192,"Block Group 2, Census Tract 323.19, King County, Washington",688,121,598,112,90,61
1500000US530330323193,530330323193,"Block Group 3, Census Tract 323.19, King County, Washington",951,196,101,49,850,187
1500000US530330323194,530330323194,"Block Group 4, Census Tract 323.19, King County, Washington",637,132,0,12,637,132
1500000US530330323201,530330323201,"Block Group 1, Census Tract 323.20, King County, Washington",430,65,393,69,37,33
1500000US530330323202,530330323202,"Block Group 2, Census Tract 323.20, King County, Washington",505,75,430,78,75,58
1500000US530330323203,530330323203,"Block Group 3, Census Tract 323.20, King County, Washington",605,58,596,60,9,14
1500000US530330323211,530330323211,"Block Group 1, Census Tract 323.21, King County, Washington",326,44,309,45,17,15
1500000US530330323212,530330323212,"Block Group 2, Census Tract 323.21, King County, Washington",384,62,331,54,53,41
1500000US530330323213,530330323213,"Block Group 3, Census Tract 323.21, King County, Washington",633,77,608,75,25,19
1500000US530330323214,530330323214,"Block Group 4, Census Tract 323.21, King County, Washington",453,61,436,62,17,19
1500000US530330323221,530330323221,"Block Group 1, Census Tract 323.22, King County, Washington",388,48,372,51,16,19
1500000US530330323222,530330323222,"Block Group 2, Census Tract 323.22, King County, Washington",286,45,257,38,29,41
1500000US530330323223,530330323223,"Block Group 3, Census Tract 323.22, King County, Washington",502,60,455,55,47,40
1500000US530330323231,530330323231,"Block Group 1, Census Tract 323.23, King County, Washington",499,118,212,80,287,91
1500000US530330323232,530330323232,"Block Group 2, Census Tract 323.23, King County, Washington",708,107,326,99,382,100
1500000US530330323233,530330323233,"Block Group 3, Census Tract 323.23, King County, Washington",496,97,460,107,36,32
1500000US530330323234,530330323234,"Block Group 4, Census Tract 323.23, King County, Washington",508,91,508,91,0,12
1500000US530330323241,530330323241,"Block Group 1, Census Tract 323.24, King County, Washington",319,62,294,66,25,30
1500000US530330323242,530330323242,"Block Group 2, Census Tract 323.24, King County, Washington",470,116,181,67,289,122
1500000US530330323243,530330323243,"Block Group 3, Census Tract 323.24, King County, Washington",906,118,358,102,548,117
1500000US530330323244,530330323244,"Block Group 4, Census Tract 323.24, King County, Washington",523,90,423,96,100,57
1500000US530330323251,530330323251,"Block Group 1, Census Tract 323.25, King County, Washington",142,47,131,46,11,22
1500000US530330323252,530330323252,"Block Group 2, Census Tract 323.25, King County, Washington",802,151,376,96,426,123
1500000US530330323253,530330323253,"Block Group 3, Census Tract 323.25, King County, Washington",1240,172,606,154,634,168
1500000US530330323261,530330323261,"Block Group 1, Census Tract 323.26, King County, Washington",480,48,466,52,14,22
1500000US530330323262,530330323262,"Block Group 2, Census Tract 323.26, King County, Washington",653,70,454,62,199,60
1500000US530330323263,530330323263,"Block Group 3, Census Tract 323.26, King County, Washington",286,60,275,61,11,18
1500000US530330323271,530330323271,"Block Group 1, Census Tract 323.27, King County, Washington",1656,117,1627,116,29,28
1500000US530330323272,530330323272,"Block Group 2, Census Tract 323.27, King County, Washington",240,57,196,46,44,45
1500000US530330323281,530330323281,"Block Group 1, Census Tract 323.28, King County, Washington",467,71,439,63,28,43
1500000US530330323282,530330323282,"Block Group 2, Census Tract 323.28, King County, Washington",319,55,276,62,43,48
1500000US530330323283,530330323283,"Block Group 3, Census Tract 323.28, King County, Washington",358,55,322,55,36,27
1500000US530330323291,530330323291,"Block Group 1, Census Tract 323.29, King County, Washington",1256,108,1064,128,192,106
1500000US530330323292,530330323292,"Block Group 2, Census Tract 323.29, King County, Washington",1815,143,1067,121,748,116
1500000US530330324011,530330324011,"Block Group 1, Census Tract 324.01, King County, Washington",593,114,507,111,86,66
1500000US530330324012,530330324012,"Block Group 2, Census Tract 324.01, King County, Washington",702,107,472,87,230,110
1500000US530330324013,530330324013,"Block Group 3, Census Tract 324.01, King County, Washington",430,114,374,112,56,69
1500000US530330324014,530330324014,"Block Group 4, Census Tract 324.01, King County, Washington",435,110,435,110,0,12
1500000US530330324021,530330324021,"Block Group 1, Census Tract 324.02, King County, Washington",740,102,724,107,16,26
1500000US530330324022,530330324022,"Block Group 2, Census Tract 324.02, King County, Washington",764,98,598,120,166,111
1500000US530330324023,530330324023,"Block Group 3, Census Tract 324.02, King County, Washington",523,97,513,94,10,21
1500000US530330324024,530330324024,"Block Group 4, Census Tract 324.02, King County, Washington",313,143,206,105,107,99
1500000US530330325001,530330325001,"Block Group 1, Census Tract 325, King County, Washington",421,74,392,74,29,25
1500000US530330325002,530330325002,"Block Group 2, Census Tract 325, King County, Washington",616,80,505,73,111,75
1500000US530330325003,530330325003,"Block Group 3, Census Tract 325, King County, Washington",385,76,198,59,187,57
1500000US530330325004,530330325004,"Block Group 4, Census Tract 325, King County, Washington",565,93,474,86,91,57
1500000US530330326011,530330326011,"Block Group 1, Census Tract 326.01, King County, Washington",722,93,438,104,284,111
1500000US530330326012,530330326012,"Block Group 2, Census Tract 326.01, King County, Washington",368,67,315,67,53,46
1500000US530330326021,530330326021,"Block Group 1, Census Tract 326.02, King County, Washington",1067,142,988,147,79,52
1500000US530330326022,530330326022,"Block Group 2, Census Tract 326.02, King County, Washington",403,106,403,106,0,12
1500000US530330326023,530330326023,"Block Group 3, Census Tract 326.02, King County, Washington",1447,142,1129,148,318,135
1500000US530330326024,530330326024,"Block Group 4, Census Tract 326.02, King County, Washington",1164,114,1064,125,100,64
1500000US530330327021,530330327021,"Block Group 1, Census Tract 327.02, King County, Washington",625,90,345,82,280,86
1500000US530330327022,530330327022,"Block Group 2, Census Tract 327.02, King County, Washington",469,91,469,91,0,12
1500000US530330327023,530330327023,"Block Group 3, Census Tract 327.02, King County, Washington",346,93,251,81,95,76
1500000US530330327024,530330327024,"Block Group 4, Census Tract 327.02, King County, Washington",358,104,331,102,27,32
1500000US530330327025,530330327025,"Block Group 5, Census Tract 327.02, King County, Washington",432,109,332,106,100,86
1500000US530330327026,530330327026,"Block Group 6, Census Tract 327.02, King County, Washington",279,71,246,74,33,38
1500000US530330327031,530330327031,"Block Group 1, Census Tract 327.03, King County, Washington",546,75,374,75,172,60
1500000US530330327032,530330327032,"Block Group 2, Census Tract 327.03, King County, Washington",307,69,160,45,147,62
1500000US530330327041,530330327041,"Block Group 1, Census Tract 327.04, King County, Washington",615,126,549,132,66,49
1500000US530330327042,530330327042,"Block Group 2, Census Tract 327.04, King County, Washington",681,110,533,123,148,120
1500000US530330327043,530330327043,"Block Group 3, Census Tract 327.04, King County, Washington",515,97,419,71,96,83
1500000US530330327044,530330327044,"Block Group 4, Census Tract 327.04, King County, Washington",633,132,224,110,409,131
1500000US530330328001,530330328001,"Block Group 1, Census Tract 328, King County, Washington",276,67,241,66,35,26
1500000US530330328002,530330328002,"Block Group 2, Census Tract 328, King County, Washington",476,58,444,64,32,27
1500000US530330328003,530330328003,"Block Group 3, Census Tract 328, King County, Washington",234,53,166,45,68,33
1500000US530339901000,530339901000,"Block Group 0, Census Tract 9901, King County, Washington",0,12,0,12,0,12
