Id,Id2,Geography,Food Stamps Total,Margin of Error; Total:,Estimate; Household received Food Stamps/SNAP in the past 12 months:,Margin of Error; Household received Food Stamps/SNAP in the past 12 months:,Estimate; Household received Food Stamps/SNAP in the past 12 months: - Households with 1 or more persons with a disability,Margin of Error; Household received Food Stamps/SNAP in the past 12 months: - Households with 1 or more persons with a disability,Estimate; Household received Food Stamps/SNAP in the past 12 months: - Households with no persons with a disability,Margin of Error; Household received Food Stamps/SNAP in the past 12 months: - Households with no persons with a disability,Estimate; Household did not receive Food Stamps/SNAP in the past 12 months:,Margin of Error; Household did not receive Food Stamps/SNAP in the past 12 months:,Estimate; Household did not receive Food Stamps/SNAP in the past 12 months: - Households with 1 or more persons with a disability,Margin of Error; Household did not receive Food Stamps/SNAP in the past 12 months: - Households with 1 or more persons with a disability,Estimate; Household did not receive Food Stamps/SNAP in the past 12 months: - Households with no persons with a disability,Margin of Error; Household did not receive Food Stamps/SNAP in the past 12 months: - Households with no persons with a disability
1500000US530330001001,530330001001,"Block Group 1, Census Tract 1, King County, Washington",562,116,25,27,0,12,25,27,537,115,115,57,422,112
1500000US530330001002,530330001002,"Block Group 2, Census Tract 1, King County, Washington",614,156,102,82,32,53,70,64,512,140,81,74,431,135
1500000US530330001003,530330001003,"Block Group 3, Census Tract 1, King County, Washington",662,106,171,76,119,75,52,41,491,104,134,83,357,111
1500000US530330001004,530330001004,"Block Group 4, Census Tract 1, King County, Washington",823,178,262,105,81,65,181,82,561,159,68,48,493,162
1500000US530330001005,530330001005,"Block Group 5, Census Tract 1, King County, Washington",519,118,54,43,40,37,14,22,465,114,76,41,389,110
1500000US530330002001,530330002001,"Block Group 1, Census Tract 2, King County, Washington",393,73,34,39,34,39,0,12,359,75,15,24,344,73
1500000US530330002002,530330002002,"Block Group 2, Census Tract 2, King County, Washington",496,160,113,113,0,12,113,113,383,138,55,48,328,137
1500000US530330002003,530330002003,"Block Group 3, Census Tract 2, King County, Washington",861,140,54,58,32,41,22,38,807,143,82,60,725,148
1500000US530330002004,530330002004,"Block Group 4, Census Tract 2, King County, Washington",560,95,38,45,14,21,24,39,522,99,64,41,458,95
1500000US530330002005,530330002005,"Block Group 5, Census Tract 2, King County, Washington",746,144,213,125,49,45,164,122,533,128,128,68,405,125
1500000US530330002006,530330002006,"Block Group 6, Census Tract 2, King County, Washington",492,86,16,26,16,26,0,12,476,87,79,59,397,91
1500000US530330003001,530330003001,"Block Group 1, Census Tract 3, King County, Washington",471,65,73,62,8,12,65,62,398,66,61,35,337,70
1500000US530330003002,530330003002,"Block Group 2, Census Tract 3, King County, Washington",612,83,140,85,68,66,72,57,472,86,78,45,394,79
1500000US530330004011,530330004011,"Block Group 1, Census Tract 4.01, King County, Washington",1818,190,529,187,245,119,284,156,1289,198,269,94,1020,211
1500000US530330004012,530330004012,"Block Group 2, Census Tract 4.01, King County, Washington",631,128,0,12,0,12,0,12,631,128,62,43,569,128
1500000US530330004013,530330004013,"Block Group 3, Census Tract 4.01, King County, Washington",807,130,197,80,100,59,97,57,610,124,303,100,307,103
1500000US530330004021,530330004021,"Block Group 1, Census Tract 4.02, King County, Washington",484,99,33,39,18,29,15,24,451,104,89,74,362,93
1500000US530330004022,530330004022,"Block Group 2, Census Tract 4.02, King County, Washington",455,97,17,29,0,12,17,29,438,106,75,58,363,118
1500000US530330004023,530330004023,"Block Group 3, Census Tract 4.02, King County, Washington",656,159,53,48,37,43,16,27,603,161,97,84,506,144
1500000US530330004024,530330004024,"Block Group 4, Census Tract 4.02, King County, Washington",779,123,33,39,33,39,0,12,746,120,346,107,400,104
1500000US530330005001,530330005001,"Block Group 1, Census Tract 5, King County, Washington",431,45,0,12,0,12,0,12,431,45,109,51,322,67
1500000US530330005002,530330005002,"Block Group 2, Census Tract 5, King County, Washington",371,59,0,12,0,12,0,12,371,59,55,30,316,62
1500000US530330005003,530330005003,"Block Group 3, Census Tract 5, King County, Washington",428,71,10,15,10,15,0,12,418,73,73,44,345,73
1500000US530330006001,530330006001,"Block Group 1, Census Tract 6, King County, Washington",459,94,18,22,9,19,9,15,441,99,70,44,371,94
1500000US530330006002,530330006002,"Block Group 2, Census Tract 6, King County, Washington",570,144,129,85,59,70,70,77,441,140,136,113,305,99
1500000US530330006003,530330006003,"Block Group 3, Census Tract 6, King County, Washington",590,128,35,41,0,12,35,41,555,126,21,23,534,128
1500000US530330006004,530330006004,"Block Group 4, Census Tract 6, King County, Washington",760,165,68,57,38,46,30,34,692,170,63,53,629,166
1500000US530330006005,530330006005,"Block Group 5, Census Tract 6, King County, Washington",216,74,31,47,0,12,31,47,185,62,49,45,136,64
1500000US530330006006,530330006006,"Block Group 6, Census Tract 6, King County, Washington",785,157,116,72,87,55,29,47,669,171,61,65,608,172
1500000US530330007001,530330007001,"Block Group 1, Census Tract 7, King County, Washington",993,135,187,89,38,42,149,78,806,148,55,47,751,143
1500000US530330007002,530330007002,"Block Group 2, Census Tract 7, King County, Washington",460,101,47,46,13,21,34,39,413,107,72,66,341,104
1500000US530330007003,530330007003,"Block Group 3, Census Tract 7, King County, Washington",332,72,23,26,0,12,23,26,309,76,19,29,290,69
1500000US530330007004,530330007004,"Block Group 4, Census Tract 7, King County, Washington",280,67,29,33,29,33,0,12,251,71,40,36,211,70
1500000US530330008001,530330008001,"Block Group 1, Census Tract 8, King County, Washington",446,76,16,24,0,12,16,24,430,76,60,32,370,79
1500000US530330008002,530330008002,"Block Group 2, Census Tract 8, King County, Washington",564,71,59,41,8,12,51,38,505,72,56,36,449,78
1500000US530330009001,530330009001,"Block Group 1, Census Tract 9, King County, Washington",490,56,28,20,5,8,23,18,462,58,93,40,369,57
1500000US530330009002,530330009002,"Block Group 2, Census Tract 9, King County, Washington",365,49,14,17,0,12,14,17,351,51,13,14,338,51
1500000US530330010001,530330010001,"Block Group 1, Census Tract 10, King County, Washington",333,62,106,47,35,27,71,36,227,53,11,11,216,53
1500000US530330010002,530330010002,"Block Group 2, Census Tract 10, King County, Washington",412,47,20,22,4,8,16,21,392,49,25,13,367,48
1500000US530330011001,530330011001,"Block Group 1, Census Tract 11, King County, Washington",469,94,13,22,13,22,0,12,456,93,91,50,365,92
1500000US530330011002,530330011002,"Block Group 2, Census Tract 11, King County, Washington",634,96,55,40,13,18,42,36,579,101,38,29,541,102
1500000US530330012001,530330012001,"Block Group 1, Census Tract 12, King County, Washington",497,95,31,53,0,12,31,53,466,100,91,66,375,99
1500000US530330012002,530330012002,"Block Group 2, Census Tract 12, King County, Washington",496,138,0,12,0,12,0,12,496,138,21,30,475,135
1500000US530330012003,530330012003,"Block Group 3, Census Tract 12, King County, Washington",976,165,90,59,41,45,49,37,886,157,356,125,530,143
1500000US530330012004,530330012004,"Block Group 4, Census Tract 12, King County, Washington",664,145,158,98,76,56,82,82,506,156,100,56,406,151
1500000US530330012005,530330012005,"Block Group 5, Census Tract 12, King County, Washington",864,165,66,43,43,40,23,19,798,173,141,97,657,189
1500000US530330013001,530330013001,"Block Group 1, Census Tract 13, King County, Washington",818,107,78,62,39,37,39,48,740,117,147,76,593,133
1500000US530330013002,530330013002,"Block Group 2, Census Tract 13, King County, Washington",690,114,155,96,72,47,83,85,535,139,51,60,484,133
1500000US530330013003,530330013003,"Block Group 3, Census Tract 13, King County, Washington",644,112,42,40,0,12,42,40,602,114,53,54,549,111
1500000US530330014001,530330014001,"Block Group 1, Census Tract 14, King County, Washington",590,105,56,61,15,22,41,60,534,106,100,60,434,113
1500000US530330014002,530330014002,"Block Group 2, Census Tract 14, King County, Washington",374,93,26,30,15,23,11,17,348,90,64,54,284,83
1500000US530330014003,530330014003,"Block Group 3, Census Tract 14, King County, Washington",576,112,25,38,6,13,19,34,551,112,54,42,497,114
1500000US530330014004,530330014004,"Block Group 4, Census Tract 14, King County, Washington",612,101,68,98,0,12,68,98,544,86,43,43,501,94
1500000US530330015001,530330015001,"Block Group 1, Census Tract 15, King County, Washington",515,56,16,18,8,13,8,12,499,57,50,34,449,61
1500000US530330015002,530330015002,"Block Group 2, Census Tract 15, King County, Washington",605,54,8,13,0,12,8,13,597,55,142,74,455,69
1500000US530330016001,530330016001,"Block Group 1, Census Tract 16, King County, Washington",571,74,0,12,0,12,0,12,571,74,58,33,513,79
1500000US530330016002,530330016002,"Block Group 2, Census Tract 16, King County, Washington",538,74,9,15,0,12,9,15,529,75,55,32,474,77
1500000US530330016003,530330016003,"Block Group 3, Census Tract 16, King County, Washington",658,84,32,41,7,12,25,39,626,82,86,46,540,79
1500000US530330017011,530330017011,"Block Group 1, Census Tract 17.01, King County, Washington",772,112,71,67,52,63,19,21,701,92,61,48,640,96
1500000US530330017012,530330017012,"Block Group 2, Census Tract 17.01, King County, Washington",551,78,28,32,10,15,18,28,523,80,75,45,448,80
1500000US530330017013,530330017013,"Block Group 3, Census Tract 17.01, King County, Washington",623,103,32,29,12,19,20,23,591,109,80,45,511,110
1500000US530330017021,530330017021,"Block Group 1, Census Tract 17.02, King County, Washington",853,122,204,101,100,58,104,86,649,96,53,39,596,96
1500000US530330017022,530330017022,"Block Group 2, Census Tract 17.02, King County, Washington",515,94,41,36,25,25,16,25,474,105,97,56,377,101
1500000US530330017023,530330017023,"Block Group 3, Census Tract 17.02, King County, Washington",434,93,52,37,25,27,27,32,382,97,37,32,345,96
1500000US530330017024,530330017024,"Block Group 4, Census Tract 17.02, King County, Washington",260,67,14,25,14,25,0,12,246,63,34,32,212,64
1500000US530330018001,530330018001,"Block Group 1, Census Tract 18, King County, Washington",734,149,86,78,11,21,75,79,648,140,115,55,533,131
1500000US530330018002,530330018002,"Block Group 2, Census Tract 18, King County, Washington",672,120,48,45,36,41,12,20,624,123,0,12,624,123
1500000US530330018003,530330018003,"Block Group 3, Census Tract 18, King County, Washington",824,145,20,29,8,15,12,25,804,151,77,68,727,150
1500000US530330019001,530330019001,"Block Group 1, Census Tract 19, King County, Washington",1131,105,43,44,0,12,43,44,1088,110,161,71,927,115
1500000US530330019002,530330019002,"Block Group 2, Census Tract 19, King County, Washington",549,70,41,38,0,12,41,38,508,70,68,42,440,73
1500000US530330019003,530330019003,"Block Group 3, Census Tract 19, King County, Washington",426,68,19,18,11,13,8,13,407,70,119,49,288,69
1500000US530330020001,530330020001,"Block Group 1, Census Tract 20, King County, Washington",749,86,54,47,33,37,21,31,695,88,139,68,556,70
1500000US530330020002,530330020002,"Block Group 2, Census Tract 20, King County, Washington",492,71,10,14,0,12,10,14,482,69,71,50,411,69
1500000US530330020003,530330020003,"Block Group 3, Census Tract 20, King County, Washington",335,52,11,15,0,12,11,15,324,53,40,28,284,52
1500000US530330021001,530330021001,"Block Group 1, Census Tract 21, King County, Washington",600,65,7,11,0,12,7,11,593,65,111,47,482,74
1500000US530330021002,530330021002,"Block Group 2, Census Tract 21, King County, Washington",404,64,29,45,0,12,29,45,375,62,68,50,307,72
1500000US530330021003,530330021003,"Block Group 3, Census Tract 21, King County, Washington",662,82,19,21,9,13,10,16,643,84,54,36,589,88
1500000US530330022001,530330022001,"Block Group 1, Census Tract 22, King County, Washington",622,84,0,12,0,12,0,12,622,84,69,49,553,91
1500000US530330022002,530330022002,"Block Group 2, Census Tract 22, King County, Washington",552,74,14,21,0,12,14,21,538,76,113,64,425,92
1500000US530330022003,530330022003,"Block Group 3, Census Tract 22, King County, Washington",522,73,0,12,0,12,0,12,522,73,75,52,447,83
1500000US530330022004,530330022004,"Block Group 4, Census Tract 22, King County, Washington",491,75,17,25,0,12,17,25,474,74,75,52,399,87
1500000US530330024001,530330024001,"Block Group 1, Census Tract 24, King County, Washington",387,59,0,12,0,12,0,12,387,59,75,34,312,60
1500000US530330024002,530330024002,"Block Group 2, Census Tract 24, King County, Washington",344,52,21,20,7,11,14,16,323,53,51,30,272,63
1500000US530330024003,530330024003,"Block Group 3, Census Tract 24, King County, Washington",507,67,0,12,0,12,0,12,507,67,35,27,472,68
1500000US530330025001,530330025001,"Block Group 1, Census Tract 25, King County, Washington",612,64,0,12,0,12,0,12,612,64,83,43,529,71
1500000US530330025002,530330025002,"Block Group 2, Census Tract 25, King County, Washington",622,69,38,26,21,22,17,20,584,74,46,37,538,78
1500000US530330026001,530330026001,"Block Group 1, Census Tract 26, King County, Washington",516,76,9,15,9,15,0,12,507,76,29,25,478,79
1500000US530330026002,530330026002,"Block Group 2, Census Tract 26, King County, Washington",516,71,7,11,0,12,7,11,509,72,47,30,462,80
1500000US530330026003,530330026003,"Block Group 3, Census Tract 26, King County, Washington",514,70,0,12,0,12,0,12,514,70,36,20,478,71
1500000US530330026004,530330026004,"Block Group 4, Census Tract 26, King County, Washington",373,55,9,14,0,12,9,14,364,57,88,61,276,57
1500000US530330027001,530330027001,"Block Group 1, Census Tract 27, King County, Washington",623,119,12,19,0,12,12,19,611,121,11,19,600,122
1500000US530330027002,530330027002,"Block Group 2, Census Tract 27, King County, Washington",566,87,16,25,16,25,0,12,550,92,73,56,477,90
1500000US530330027003,530330027003,"Block Group 3, Census Tract 27, King County, Washington",434,99,14,25,14,25,0,12,420,99,55,46,365,95
1500000US530330027004,530330027004,"Block Group 4, Census Tract 27, King County, Washington",644,89,11,18,11,18,0,12,633,90,61,44,572,96
1500000US530330028001,530330028001,"Block Group 1, Census Tract 28, King County, Washington",351,104,0,12,0,12,0,12,351,104,36,41,315,98
1500000US530330028002,530330028002,"Block Group 2, Census Tract 28, King County, Washington",428,76,0,12,0,12,0,12,428,76,52,51,376,89
1500000US530330028003,530330028003,"Block Group 3, Census Tract 28, King County, Washington",519,102,32,35,18,26,14,23,487,100,35,34,452,102
1500000US530330028004,530330028004,"Block Group 4, Census Tract 28, King County, Washington",650,93,30,45,30,45,0,12,620,94,91,65,529,111
1500000US530330029001,530330029001,"Block Group 1, Census Tract 29, King County, Washington",643,85,46,45,8,12,38,42,597,80,61,40,536,83
1500000US530330029002,530330029002,"Block Group 2, Census Tract 29, King County, Washington",620,75,46,35,23,35,23,36,574,74,44,31,530,73
1500000US530330029003,530330029003,"Block Group 3, Census Tract 29, King County, Washington",533,79,8,12,0,12,8,12,525,78,23,20,502,80
1500000US530330030001,530330030001,"Block Group 1, Census Tract 30, King County, Washington",697,86,14,24,14,24,0,12,683,84,104,62,579,100
1500000US530330030002,530330030002,"Block Group 2, Census Tract 30, King County, Washington",602,93,35,39,0,12,35,39,567,95,42,38,525,104
1500000US530330030003,530330030003,"Block Group 3, Census Tract 30, King County, Washington",590,91,63,52,63,52,0,12,527,92,26,28,501,98
1500000US530330030004,530330030004,"Block Group 4, Census Tract 30, King County, Washington",534,116,0,12,0,12,0,12,534,116,73,79,461,104
1500000US530330031001,530330031001,"Block Group 1, Census Tract 31, King County, Washington",513,77,0,12,0,12,0,12,513,77,66,52,447,98
1500000US530330031002,530330031002,"Block Group 2, Census Tract 31, King County, Washington",411,69,26,31,0,12,26,31,385,68,32,40,353,69
1500000US530330031003,530330031003,"Block Group 3, Census Tract 31, King County, Washington",461,107,38,20,29,23,9,14,423,109,29,33,394,109
1500000US530330031004,530330031004,"Block Group 4, Census Tract 31, King County, Washington",646,81,9,15,9,15,0,12,637,84,43,39,594,96
1500000US530330031005,530330031005,"Block Group 5, Census Tract 31, King County, Washington",520,62,25,30,0,12,25,30,495,69,49,37,446,79
1500000US530330032001,530330032001,"Block Group 1, Census Tract 32, King County, Washington",434,93,28,30,0,12,28,30,406,95,29,31,377,98
1500000US530330032002,530330032002,"Block Group 2, Census Tract 32, King County, Washington",791,141,45,41,30,34,15,24,746,142,77,55,669,143
1500000US530330032003,530330032003,"Block Group 3, Census Tract 32, King County, Washington",602,108,50,48,37,43,13,21,552,104,43,41,509,116
1500000US530330032004,530330032004,"Block Group 4, Census Tract 32, King County, Washington",685,135,60,43,14,22,46,43,625,133,89,53,536,139
1500000US530330032005,530330032005,"Block Group 5, Census Tract 32, King County, Washington",251,67,0,12,0,12,0,12,251,67,10,16,241,66
1500000US530330032006,530330032006,"Block Group 6, Census Tract 32, King County, Washington",760,153,52,77,0,12,52,77,708,151,175,96,533,151
1500000US530330032007,530330032007,"Block Group 7, Census Tract 32, King County, Washington",445,139,0,12,0,12,0,12,445,139,67,51,378,135
1500000US530330033001,530330033001,"Block Group 1, Census Tract 33, King County, Washington",580,103,42,45,24,41,18,20,538,100,16,25,522,104
1500000US530330033002,530330033002,"Block Group 2, Census Tract 33, King County, Washington",400,113,0,12,0,12,0,12,400,113,86,68,314,102
1500000US530330033003,530330033003,"Block Group 3, Census Tract 33, King County, Washington",1019,142,69,65,0,12,69,65,950,132,48,49,902,141
1500000US530330033004,530330033004,"Block Group 4, Census Tract 33, King County, Washington",604,133,36,39,0,12,36,39,568,127,94,86,474,101
1500000US530330033005,530330033005,"Block Group 5, Census Tract 33, King County, Washington",518,95,18,21,0,12,18,21,500,97,32,36,468,106
1500000US530330034001,530330034001,"Block Group 1, Census Tract 34, King County, Washington",474,67,17,18,0,12,17,18,457,70,45,51,412,65
1500000US530330034002,530330034002,"Block Group 2, Census Tract 34, King County, Washington",594,81,0,12,0,12,0,12,594,81,44,31,550,87
1500000US530330034003,530330034003,"Block Group 3, Census Tract 34, King County, Washington",435,68,20,19,5,9,15,17,415,69,62,41,353,69
1500000US530330035001,530330035001,"Block Group 1, Census Tract 35, King County, Washington",661,76,69,40,60,39,9,14,592,84,70,40,522,84
1500000US530330035002,530330035002,"Block Group 2, Census Tract 35, King County, Washington",669,89,9,14,0,12,9,14,660,92,74,45,586,86
1500000US530330035003,530330035003,"Block Group 3, Census Tract 35, King County, Washington",525,74,0,12,0,12,0,12,525,74,66,47,459,82
1500000US530330036001,530330036001,"Block Group 1, Census Tract 36, King County, Washington",741,108,30,32,0,12,30,32,711,113,57,40,654,117
1500000US530330036002,530330036002,"Block Group 2, Census Tract 36, King County, Washington",848,145,73,45,42,32,31,34,775,143,45,34,730,144
1500000US530330036003,530330036003,"Block Group 3, Census Tract 36, King County, Washington",520,95,44,34,14,22,30,33,476,93,68,50,408,92
1500000US530330036004,530330036004,"Block Group 4, Census Tract 36, King County, Washington",1043,145,12,19,12,19,0,12,1031,147,152,95,879,147
1500000US530330038001,530330038001,"Block Group 1, Census Tract 38, King County, Washington",501,60,5,8,5,8,0,12,496,60,156,63,340,68
1500000US530330038002,530330038002,"Block Group 2, Census Tract 38, King County, Washington",370,47,15,17,8,11,7,13,355,43,40,24,315,46
1500000US530330039001,530330039001,"Block Group 1, Census Tract 39, King County, Washington",757,65,22,32,0,12,22,32,735,61,107,51,628,69
1500000US530330039002,530330039002,"Block Group 2, Census Tract 39, King County, Washington",408,47,0,12,0,12,0,12,408,47,59,37,349,54
1500000US530330040001,530330040001,"Block Group 1, Census Tract 40, King County, Washington",964,63,137,56,58,53,79,70,827,70,75,40,752,78
1500000US530330040002,530330040002,"Block Group 2, Census Tract 40, King County, Washington",369,49,22,25,12,20,10,15,347,51,27,23,320,55
1500000US530330041001,530330041001,"Block Group 1, Census Tract 41, King County, Washington",619,116,0,12,0,12,0,12,619,116,16,25,603,120
1500000US530330041002,530330041002,"Block Group 2, Census Tract 41, King County, Washington",619,96,0,12,0,12,0,12,619,96,198,74,421,88
1500000US530330041003,530330041003,"Block Group 3, Census Tract 41, King County, Washington",482,91,25,37,25,37,0,12,457,94,45,35,412,97
1500000US530330041004,530330041004,"Block Group 4, Census Tract 41, King County, Washington",547,112,18,28,0,12,18,28,529,114,73,60,456,119
1500000US530330041005,530330041005,"Block Group 5, Census Tract 41, King County, Washington",363,73,26,30,0,12,26,30,337,77,33,39,304,78
1500000US530330041006,530330041006,"Block Group 6, Census Tract 41, King County, Washington",321,92,0,12,0,12,0,12,321,92,120,82,201,83
1500000US530330042001,530330042001,"Block Group 1, Census Tract 42, King County, Washington",736,105,50,74,0,12,50,74,686,100,35,34,651,106
1500000US530330042002,530330042002,"Block Group 2, Census Tract 42, King County, Washington",609,76,57,30,28,31,29,34,552,79,124,79,428,83
1500000US530330042003,530330042003,"Block Group 3, Census Tract 42, King County, Washington",624,97,42,49,30,45,12,19,582,90,49,41,533,92
1500000US530330042004,530330042004,"Block Group 4, Census Tract 42, King County, Washington",642,94,14,25,0,12,14,25,628,100,21,26,607,106
1500000US530330042005,530330042005,"Block Group 5, Census Tract 42, King County, Washington",567,82,10,15,0,12,10,15,557,86,0,12,557,86
1500000US530330043011,530330043011,"Block Group 1, Census Tract 43.01, King County, Washington",432,95,43,41,16,20,27,35,389,96,49,44,340,85
1500000US530330043012,530330043012,"Block Group 2, Census Tract 43.01, King County, Washington",446,74,9,16,9,16,0,12,437,72,11,13,426,73
1500000US530330043013,530330043013,"Block Group 3, Census Tract 43.01, King County, Washington",510,78,21,24,10,18,11,16,489,82,97,46,392,85
1500000US530330043021,530330043021,"Block Group 1, Census Tract 43.02, King County, Washington",538,120,47,64,0,12,47,64,491,123,40,45,451,123
1500000US530330043022,530330043022,"Block Group 2, Census Tract 43.02, King County, Washington",831,137,104,73,43,33,61,69,727,124,169,81,558,108
1500000US530330044001,530330044001,"Block Group 1, Census Tract 44, King County, Washington",484,107,22,37,0,12,22,37,462,107,26,40,436,108
1500000US530330044002,530330044002,"Block Group 2, Census Tract 44, King County, Washington",726,155,27,42,0,12,27,42,699,151,83,58,616,151
1500000US530330044003,530330044003,"Block Group 3, Census Tract 44, King County, Washington",321,117,15,24,15,24,0,12,306,118,16,25,290,116
1500000US530330044004,530330044004,"Block Group 4, Census Tract 44, King County, Washington",782,184,63,49,14,22,49,45,719,189,15,25,704,191
1500000US530330045001,530330045001,"Block Group 1, Census Tract 45, King County, Washington",369,61,8,11,0,12,8,11,361,61,9,13,352,61
1500000US530330045002,530330045002,"Block Group 2, Census Tract 45, King County, Washington",610,65,25,20,0,12,25,20,585,67,96,45,489,72
1500000US530330046001,530330046001,"Block Group 1, Census Tract 46, King County, Washington",418,74,0,12,0,12,0,12,418,74,52,46,366,69
1500000US530330046002,530330046002,"Block Group 2, Census Tract 46, King County, Washington",625,64,37,37,0,12,37,37,588,69,22,20,566,68
1500000US530330046003,530330046003,"Block Group 3, Census Tract 46, King County, Washington",367,57,0,12,0,12,0,12,367,57,108,61,259,51
1500000US530330047001,530330047001,"Block Group 1, Census Tract 47, King County, Washington",606,203,0,12,0,12,0,12,606,203,80,80,526,203
1500000US530330047002,530330047002,"Block Group 2, Census Tract 47, King County, Washington",839,210,0,12,0,12,0,12,839,210,17,27,822,211
1500000US530330047003,530330047003,"Block Group 3, Census Tract 47, King County, Washington",1413,211,60,61,18,32,42,50,1353,214,137,70,1216,210
1500000US530330047004,530330047004,"Block Group 4, Census Tract 47, King County, Washington",1746,224,65,63,0,12,65,63,1681,223,252,157,1429,230
1500000US530330048001,530330048001,"Block Group 1, Census Tract 48, King County, Washington",467,96,16,25,16,25,0,12,451,96,0,12,451,96
1500000US530330048002,530330048002,"Block Group 2, Census Tract 48, King County, Washington",566,100,18,27,0,12,18,27,548,102,41,47,507,100
1500000US530330048003,530330048003,"Block Group 3, Census Tract 48, King County, Washington",567,91,28,32,0,12,28,32,539,93,44,42,495,96
1500000US530330048004,530330048004,"Block Group 4, Census Tract 48, King County, Washington",526,90,0,12,0,12,0,12,526,90,28,32,498,101
1500000US530330049001,530330049001,"Block Group 1, Census Tract 49, King County, Washington",581,114,107,85,32,27,75,86,474,92,31,30,443,99
1500000US530330049002,530330049002,"Block Group 2, Census Tract 49, King County, Washington",648,101,58,57,0,12,58,57,590,109,34,39,556,109
1500000US530330049003,530330049003,"Block Group 3, Census Tract 49, King County, Washington",685,109,22,34,0,12,22,34,663,116,15,25,648,122
1500000US530330049004,530330049004,"Block Group 4, Census Tract 49, King County, Washington",797,120,13,20,0,12,13,20,784,122,15,25,769,121
1500000US530330049005,530330049005,"Block Group 5, Census Tract 49, King County, Washington",886,140,47,44,12,20,35,39,839,148,9,14,830,149
1500000US530330050001,530330050001,"Block Group 1, Census Tract 50, King County, Washington",658,86,17,19,8,12,9,15,641,88,40,44,601,90
1500000US530330050002,530330050002,"Block Group 2, Census Tract 50, King County, Washington",394,78,0,12,0,12,0,12,394,78,8,13,386,79
1500000US530330050003,530330050003,"Block Group 3, Census Tract 50, King County, Washington",811,114,75,73,58,71,17,20,736,103,199,86,537,103
1500000US530330051001,530330051001,"Block Group 1, Census Tract 51, King County, Washington",666,84,17,19,17,19,0,12,649,83,55,37,594,80
1500000US530330051002,530330051002,"Block Group 2, Census Tract 51, King County, Washington",547,69,14,15,14,15,0,12,533,70,74,32,459,76
1500000US530330051003,530330051003,"Block Group 3, Census Tract 51, King County, Washington",395,57,11,16,0,12,11,16,384,59,15,17,369,62
1500000US530330052001,530330052001,"Block Group 1, Census Tract 52, King County, Washington",472,118,95,88,15,24,80,85,377,117,31,34,346,118
1500000US530330052002,530330052002,"Block Group 2, Census Tract 52, King County, Washington",678,142,33,38,19,31,14,21,645,145,0,12,645,145
1500000US530330052003,530330052003,"Block Group 3, Census Tract 52, King County, Washington",562,104,13,20,13,20,0,12,549,107,40,45,509,106
1500000US530330052004,530330052004,"Block Group 4, Census Tract 52, King County, Washington",539,113,50,82,0,12,50,82,489,84,104,65,385,85
1500000US530330052005,530330052005,"Block Group 5, Census Tract 52, King County, Washington",627,140,87,47,50,47,37,43,540,138,50,42,490,142
1500000US530330053011,530330053011,"Block Group 1, Census Tract 53.01, King County, Washington",331,121,14,22,14,22,0,12,317,118,45,65,272,100
1500000US530330053012,530330053012,"Block Group 2, Census Tract 53.01, King County, Washington",1050,151,96,50,62,43,34,35,954,163,94,90,860,138
1500000US530330053013,530330053013,"Block Group 3, Census Tract 53.01, King County, Washington",634,110,80,83,80,83,0,12,554,112,40,41,514,110
1500000US530330053014,530330053014,"Block Group 4, Census Tract 53.01, King County, Washington",638,125,41,66,0,12,41,66,597,112,105,66,492,100
1500000US530330053021,530330053021,"Block Group 1, Census Tract 53.02, King County, Washington",125,27,0,12,0,12,0,12,125,27,0,12,125,27
1500000US530330053022,530330053022,"Block Group 2, Census Tract 53.02, King County, Washington",14,14,0,12,0,12,0,12,14,14,0,12,14,14
1500000US530330053023,530330053023,"Block Group 3, Census Tract 53.02, King County, Washington",0,12,0,12,0,12,0,12,0,12,0,12,0,12
1500000US530330054001,530330054001,"Block Group 1, Census Tract 54, King County, Washington",391,84,1,10,1,10,0,12,390,84,48,60,342,76
1500000US530330054002,530330054002,"Block Group 2, Census Tract 54, King County, Washington",762,128,63,70,0,12,63,70,699,123,45,43,654,133
1500000US530330054003,530330054003,"Block Group 3, Census Tract 54, King County, Washington",713,115,73,96,0,12,73,96,640,109,99,69,541,111
1500000US530330054004,530330054004,"Block Group 4, Census Tract 54, King County, Washington",871,120,48,45,0,12,48,45,823,123,26,30,797,125
1500000US530330056001,530330056001,"Block Group 1, Census Tract 56, King County, Washington",562,82,0,12,0,12,0,12,562,82,45,41,517,86
1500000US530330056002,530330056002,"Block Group 2, Census Tract 56, King County, Washington",619,98,0,12,0,12,0,12,619,98,170,90,449,98
1500000US530330056003,530330056003,"Block Group 3, Census Tract 56, King County, Washington",453,68,0,12,0,12,0,12,453,68,89,50,364,79
1500000US530330056004,530330056004,"Block Group 4, Census Tract 56, King County, Washington",435,63,0,12,0,12,0,12,435,63,83,60,352,62
1500000US530330056005,530330056005,"Block Group 5, Census Tract 56, King County, Washington",476,102,19,29,0,12,19,29,457,102,30,35,427,97
1500000US530330057001,530330057001,"Block Group 1, Census Tract 57, King County, Washington",203,82,0,12,0,12,0,12,203,82,68,57,135,83
1500000US530330057002,530330057002,"Block Group 2, Census Tract 57, King County, Washington",553,103,0,12,0,12,0,12,553,103,78,62,475,111
1500000US530330057003,530330057003,"Block Group 3, Census Tract 57, King County, Washington",375,117,0,12,0,12,0,12,375,117,53,36,322,115
1500000US530330057004,530330057004,"Block Group 4, Census Tract 57, King County, Washington",336,79,0,12,0,12,0,12,336,79,78,56,258,85
1500000US530330057005,530330057005,"Block Group 5, Census Tract 57, King County, Washington",573,99,0,12,0,12,0,12,573,99,133,67,440,104
1500000US530330057006,530330057006,"Block Group 6, Census Tract 57, King County, Washington",687,105,29,32,29,32,0,12,658,101,32,37,626,102
1500000US530330058011,530330058011,"Block Group 1, Census Tract 58.01, King County, Washington",570,100,0,12,0,12,0,12,570,100,18,28,552,97
1500000US530330058012,530330058012,"Block Group 2, Census Tract 58.01, King County, Washington",809,115,16,26,16,26,0,12,793,119,114,86,679,135
1500000US530330058013,530330058013,"Block Group 3, Census Tract 58.01, King County, Washington",538,101,11,17,0,12,11,17,527,102,94,62,433,96
1500000US530330058014,530330058014,"Block Group 4, Census Tract 58.01, King County, Washington",683,133,124,89,29,33,95,85,559,126,90,46,469,130
1500000US530330058021,530330058021,"Block Group 1, Census Tract 58.02, King County, Washington",883,161,60,77,0,12,60,77,823,158,60,48,763,169
1500000US530330058022,530330058022,"Block Group 2, Census Tract 58.02, King County, Washington",1047,159,28,32,12,20,16,24,1019,162,151,109,868,150
1500000US530330058023,530330058023,"Block Group 3, Census Tract 58.02, King County, Washington",720,159,101,93,16,25,85,90,619,151,71,53,548,145
1500000US530330059001,530330059001,"Block Group 1, Census Tract 59, King County, Washington",853,140,32,35,32,35,0,12,821,145,77,59,744,147
1500000US530330059002,530330059002,"Block Group 2, Census Tract 59, King County, Washington",569,116,0,12,0,12,0,12,569,116,68,35,501,116
1500000US530330059003,530330059003,"Block Group 3, Census Tract 59, King County, Washington",215,96,0,12,0,12,0,12,215,96,0,12,215,96
1500000US530330059004,530330059004,"Block Group 4, Census Tract 59, King County, Washington",609,111,0,12,0,12,0,12,609,111,15,22,594,116
1500000US530330059005,530330059005,"Block Group 5, Census Tract 59, King County, Washington",440,111,13,20,0,12,13,20,427,111,28,29,399,113
1500000US530330060001,530330060001,"Block Group 1, Census Tract 60, King County, Washington",813,128,47,43,27,33,20,29,766,136,78,44,688,131
1500000US530330060002,530330060002,"Block Group 2, Census Tract 60, King County, Washington",557,95,0,12,0,12,0,12,557,95,77,70,480,98
1500000US530330060003,530330060003,"Block Group 3, Census Tract 60, King County, Washington",497,96,12,19,12,19,0,12,485,97,14,22,471,96
1500000US530330060004,530330060004,"Block Group 4, Census Tract 60, King County, Washington",506,102,0,12,0,12,0,12,506,102,16,25,490,103
1500000US530330061001,530330061001,"Block Group 1, Census Tract 61, King County, Washington",641,105,17,27,0,12,17,27,624,107,0,12,624,107
1500000US530330061002,530330061002,"Block Group 2, Census Tract 61, King County, Washington",549,114,14,24,0,12,14,24,535,116,77,57,458,117
1500000US530330061003,530330061003,"Block Group 3, Census Tract 61, King County, Washington",897,124,0,12,0,12,0,12,897,124,24,28,873,119
1500000US530330061004,530330061004,"Block Group 4, Census Tract 61, King County, Washington",872,136,13,21,13,21,0,12,859,136,46,57,813,137
1500000US530330062001,530330062001,"Block Group 1, Census Tract 62, King County, Washington",655,55,60,42,32,29,28,31,595,66,63,39,532,70
1500000US530330062002,530330062002,"Block Group 2, Census Tract 62, King County, Washington",605,55,9,14,0,12,9,14,596,55,44,30,552,62
1500000US530330062003,530330062003,"Block Group 3, Census Tract 62, King County, Washington",341,37,7,11,0,12,7,11,334,37,8,14,326,38
1500000US530330063001,530330063001,"Block Group 1, Census Tract 63, King County, Washington",810,147,0,12,0,12,0,12,810,147,86,82,724,141
1500000US530330063002,530330063002,"Block Group 2, Census Tract 63, King County, Washington",564,110,0,12,0,12,0,12,564,110,129,70,435,104
1500000US530330063003,530330063003,"Block Group 3, Census Tract 63, King County, Washington",582,139,0,12,0,12,0,12,582,139,38,33,544,139
1500000US530330063004,530330063004,"Block Group 4, Census Tract 63, King County, Washington",515,72,0,12,0,12,0,12,515,72,66,53,449,80
1500000US530330064001,530330064001,"Block Group 1, Census Tract 64, King County, Washington",458,67,0,12,0,12,0,12,458,67,53,31,405,72
1500000US530330064002,530330064002,"Block Group 2, Census Tract 64, King County, Washington",384,62,0,12,0,12,0,12,384,62,36,30,348,71
1500000US530330064003,530330064003,"Block Group 3, Census Tract 64, King County, Washington",445,58,0,12,0,12,0,12,445,58,52,31,393,62
1500000US530330065001,530330065001,"Block Group 1, Census Tract 65, King County, Washington",490,86,0,12,0,12,0,12,490,86,55,60,435,91
1500000US530330065002,530330065002,"Block Group 2, Census Tract 65, King County, Washington",999,131,0,12,0,12,0,12,999,131,103,69,896,138
1500000US530330065003,530330065003,"Block Group 3, Census Tract 65, King County, Washington",909,133,12,19,12,19,0,12,897,134,99,61,798,143
1500000US530330066001,530330066001,"Block Group 1, Census Tract 66, King County, Washington",977,166,0,12,0,12,0,12,977,166,56,40,921,167
1500000US530330066002,530330066002,"Block Group 2, Census Tract 66, King County, Washington",1117,171,90,103,9,13,81,103,1027,174,109,83,918,172
1500000US530330067001,530330067001,"Block Group 1, Census Tract 67, King County, Washington",1331,194,16,26,0,12,16,26,1315,193,26,31,1289,197
1500000US530330067002,530330067002,"Block Group 2, Census Tract 67, King County, Washington",1095,179,0,12,0,12,0,12,1095,179,165,107,930,169
1500000US530330067003,530330067003,"Block Group 3, Census Tract 67, King County, Washington",618,128,0,12,0,12,0,12,618,128,26,41,592,124
1500000US530330067004,530330067004,"Block Group 4, Census Tract 67, King County, Washington",961,172,0,12,0,12,0,12,961,172,147,82,814,171
1500000US530330068001,530330068001,"Block Group 1, Census Tract 68, King County, Washington",566,62,16,17,6,9,10,16,550,66,21,19,529,64
1500000US530330068002,530330068002,"Block Group 2, Census Tract 68, King County, Washington",801,92,37,29,25,22,12,19,764,97,63,35,701,91
1500000US530330069001,530330069001,"Block Group 1, Census Tract 69, King County, Washington",505,98,14,23,14,23,0,12,491,95,15,23,476,92
1500000US530330069002,530330069002,"Block Group 2, Census Tract 69, King County, Washington",545,66,36,57,0,12,36,57,509,68,72,42,437,75
1500000US530330069003,530330069003,"Block Group 3, Census Tract 69, King County, Washington",475,80,40,34,20,32,20,33,435,77,37,39,398,77
1500000US530330069004,530330069004,"Block Group 4, Census Tract 69, King County, Washington",559,97,16,26,0,12,16,26,543,102,21,33,522,105
1500000US530330070001,530330070001,"Block Group 1, Census Tract 70, King County, Washington",648,182,0,12,0,12,0,12,648,182,42,51,606,187
1500000US530330070002,530330070002,"Block Group 2, Census Tract 70, King County, Washington",820,176,108,120,83,114,25,40,712,175,29,47,683,172
1500000US530330070003,530330070003,"Block Group 3, Census Tract 70, King County, Washington",1112,182,16,28,0,12,16,28,1096,185,210,141,886,201
1500000US530330070004,530330070004,"Block Group 4, Census Tract 70, King County, Washington",757,144,42,36,42,36,0,12,715,144,20,32,695,146
1500000US530330070005,530330070005,"Block Group 5, Census Tract 70, King County, Washington",783,151,51,60,23,38,28,44,732,149,77,74,655,149
1500000US530330070006,530330070006,"Block Group 6, Census Tract 70, King County, Washington",889,166,131,101,94,92,37,45,758,162,20,31,738,163
1500000US530330071001,530330071001,"Block Group 1, Census Tract 71, King County, Washington",957,139,170,102,84,55,86,88,787,116,65,53,722,119
1500000US530330071002,530330071002,"Block Group 2, Census Tract 71, King County, Washington",1334,140,17,19,7,11,10,16,1317,141,84,52,1233,148
1500000US530330072001,530330072001,"Block Group 1, Census Tract 72, King County, Washington",2136,264,225,112,104,78,121,92,1911,271,158,115,1753,264
1500000US530330072002,530330072002,"Block Group 2, Census Tract 72, King County, Washington",1115,196,13,23,0,12,13,23,1102,196,107,107,995,205
1500000US530330072003,530330072003,"Block Group 3, Census Tract 72, King County, Washington",1227,232,139,71,38,45,101,75,1088,227,28,35,1060,230
1500000US530330073001,530330073001,"Block Group 1, Census Tract 73, King County, Washington",1338,228,92,52,44,40,48,42,1246,235,138,98,1108,213
1500000US530330073002,530330073002,"Block Group 2, Census Tract 73, King County, Washington",1000,171,220,117,150,97,70,75,780,167,145,95,635,136
1500000US530330073003,530330073003,"Block Group 3, Census Tract 73, King County, Washington",1102,201,63,54,30,35,33,41,1039,203,107,99,932,191
1500000US530330074011,530330074011,"Block Group 1, Census Tract 74.01, King County, Washington",827,166,16,26,16,26,0,12,811,165,37,41,774,179
1500000US530330074012,530330074012,"Block Group 2, Census Tract 74.01, King County, Washington",1009,201,164,101,36,43,128,98,845,203,0,12,845,203
1500000US530330074013,530330074013,"Block Group 3, Census Tract 74.01, King County, Washington",833,174,26,32,0,12,26,32,807,175,164,119,643,156
1500000US530330074014,530330074014,"Block Group 4, Census Tract 74.01, King County, Washington",692,162,0,12,0,12,0,12,692,162,52,48,640,171
1500000US530330074021,530330074021,"Block Group 1, Census Tract 74.02, King County, Washington",1255,178,64,65,0,12,64,65,1191,174,13,20,1178,172
1500000US530330074022,530330074022,"Block Group 2, Census Tract 74.02, King County, Washington",1144,233,194,86,108,77,86,61,950,227,37,58,913,230
1500000US530330074023,530330074023,"Block Group 3, Census Tract 74.02, King County, Washington",1109,178,245,76,171,64,74,78,864,175,60,43,804,176
1500000US530330075001,530330075001,"Block Group 1, Census Tract 75, King County, Washington",1107,224,154,114,41,54,113,103,953,230,107,119,846,234
1500000US530330075002,530330075002,"Block Group 2, Census Tract 75, King County, Washington",715,145,20,31,0,12,20,31,695,149,54,61,641,147
1500000US530330075003,530330075003,"Block Group 3, Census Tract 75, King County, Washington",1084,191,10,16,0,12,10,16,1074,191,13,22,1061,192
1500000US530330075004,530330075004,"Block Group 4, Census Tract 75, King County, Washington",1184,183,95,60,0,12,95,60,1089,182,85,100,1004,172
1500000US530330075005,530330075005,"Block Group 5, Census Tract 75, King County, Washington",610,111,23,35,23,35,0,12,587,111,94,77,493,119
1500000US530330076001,530330076001,"Block Group 1, Census Tract 76, King County, Washington",546,76,8,14,8,14,0,12,538,75,40,32,498,78
1500000US530330076002,530330076002,"Block Group 2, Census Tract 76, King County, Washington",661,102,89,66,19,22,70,62,572,97,51,33,521,94
1500000US530330076003,530330076003,"Block Group 3, Census Tract 76, King County, Washington",742,101,17,21,0,12,17,21,725,102,74,62,651,99
1500000US530330077001,530330077001,"Block Group 1, Census Tract 77, King County, Washington",532,109,67,73,0,12,67,73,465,101,67,59,398,107
1500000US530330077002,530330077002,"Block Group 2, Census Tract 77, King County, Washington",459,96,22,34,0,12,22,34,437,98,98,80,339,87
1500000US530330077003,530330077003,"Block Group 3, Census Tract 77, King County, Washington",449,90,51,59,0,12,51,59,398,90,28,45,370,90
1500000US530330077004,530330077004,"Block Group 4, Census Tract 77, King County, Washington",699,125,112,103,36,56,76,91,587,109,28,25,559,116
1500000US530330078001,530330078001,"Block Group 1, Census Tract 78, King County, Washington",571,101,0,12,0,12,0,12,571,101,19,29,552,99
1500000US530330078002,530330078002,"Block Group 2, Census Tract 78, King County, Washington",595,99,14,21,0,12,14,21,581,102,85,62,496,97
1500000US530330078003,530330078003,"Block Group 3, Census Tract 78, King County, Washington",469,95,93,82,0,12,93,82,376,92,29,37,347,88
1500000US530330078004,530330078004,"Block Group 4, Census Tract 78, King County, Washington",505,80,52,56,21,30,31,43,453,82,26,39,427,82
1500000US530330079001,530330079001,"Block Group 1, Census Tract 79, King County, Washington",470,130,80,79,63,79,17,26,390,132,29,32,361,136
1500000US530330079002,530330079002,"Block Group 2, Census Tract 79, King County, Washington",537,109,101,65,68,53,33,38,436,113,29,35,407,116
1500000US530330079003,530330079003,"Block Group 3, Census Tract 79, King County, Washington",449,109,33,37,0,12,33,37,416,109,33,37,383,110
1500000US530330079004,530330079004,"Block Group 4, Census Tract 79, King County, Washington",811,119,168,107,82,58,86,91,643,125,158,102,485,119
1500000US530330079005,530330079005,"Block Group 5, Census Tract 79, King County, Washington",801,112,69,54,50,47,19,30,732,112,69,47,663,118
1500000US530330080011,530330080011,"Block Group 1, Census Tract 80.01, King County, Washington",849,171,44,70,0,12,44,70,805,182,67,90,738,169
1500000US530330080012,530330080012,"Block Group 2, Census Tract 80.01, King County, Washington",790,242,166,153,24,38,142,148,624,202,174,168,450,156
1500000US530330080013,530330080013,"Block Group 3, Census Tract 80.01, King County, Washington",696,160,109,84,56,65,53,59,587,166,18,30,569,170
1500000US530330080014,530330080014,"Block Group 4, Census Tract 80.01, King County, Washington",781,234,91,40,56,49,35,42,690,229,0,12,690,229
1500000US530330080015,530330080015,"Block Group 5, Census Tract 80.01, King County, Washington",672,184,14,23,14,23,0,12,658,186,88,77,570,179
1500000US530330080021,530330080021,"Block Group 1, Census Tract 80.02, King County, Washington",1229,141,585,133,258,101,327,133,644,152,102,62,542,141
1500000US530330080022,530330080022,"Block Group 2, Census Tract 80.02, King County, Washington",913,118,136,88,87,81,49,41,777,121,71,51,706,129
1500000US530330081001,530330081001,"Block Group 1, Census Tract 81, King County, Washington",1139,171,38,61,0,12,38,61,1101,177,152,87,949,195
1500000US530330081002,530330081002,"Block Group 2, Census Tract 81, King County, Washington",325,97,61,42,46,40,15,23,264,95,15,24,249,93
1500000US530330081003,530330081003,"Block Group 3, Census Tract 81, King County, Washington",971,131,349,129,261,128,88,49,622,131,69,72,553,128
1500000US530330082001,530330082001,"Block Group 1, Census Tract 82, King County, Washington",760,139,45,41,45,41,0,12,715,147,86,90,629,130
1500000US530330082002,530330082002,"Block Group 2, Census Tract 82, King County, Washington",1030,147,86,89,18,28,68,85,944,140,90,57,854,146
1500000US530330082003,530330082003,"Block Group 3, Census Tract 82, King County, Washington",731,130,27,35,7,13,20,32,704,130,207,91,497,119
1500000US530330083001,530330083001,"Block Group 1, Census Tract 83, King County, Washington",790,100,115,53,55,41,60,41,675,110,70,48,605,96
1500000US530330083002,530330083002,"Block Group 2, Census Tract 83, King County, Washington",1158,115,55,53,38,48,17,20,1103,106,147,70,956,103
1500000US530330084001,530330084001,"Block Group 1, Census Tract 84, King County, Washington",1084,153,117,94,18,27,99,90,967,157,62,49,905,161
1500000US530330084002,530330084002,"Block Group 2, Census Tract 84, King County, Washington",1067,158,160,107,74,78,86,79,907,157,147,72,760,158
1500000US530330084003,530330084003,"Block Group 3, Census Tract 84, King County, Washington",853,138,106,90,16,27,90,91,747,152,40,33,707,154
1500000US530330085001,530330085001,"Block Group 1, Census Tract 85, King County, Washington",746,79,92,58,27,26,65,49,654,88,189,55,465,86
1500000US530330085002,530330085002,"Block Group 2, Census Tract 85, King County, Washington",653,92,148,64,74,55,74,47,505,89,138,60,367,85
1500000US530330085003,530330085003,"Block Group 3, Census Tract 85, King County, Washington",409,79,278,80,203,81,75,48,131,61,26,31,105,58
1500000US530330086001,530330086001,"Block Group 1, Census Tract 86, King County, Washington",658,109,149,62,71,53,78,48,509,109,6,10,503,108
1500000US530330086002,530330086002,"Block Group 2, Census Tract 86, King County, Washington",611,93,23,24,14,19,9,16,588,91,12,19,576,93
1500000US530330086003,530330086003,"Block Group 3, Census Tract 86, King County, Washington",545,103,152,70,100,61,52,35,393,102,45,32,348,100
1500000US530330087001,530330087001,"Block Group 1, Census Tract 87, King County, Washington",647,104,77,62,0,12,77,62,570,112,101,62,469,103
1500000US530330087002,530330087002,"Block Group 2, Census Tract 87, King County, Washington",472,91,101,73,75,67,26,28,371,90,52,50,319,83
1500000US530330087003,530330087003,"Block Group 3, Census Tract 87, King County, Washington",625,97,98,49,30,24,68,43,527,99,80,49,447,91
1500000US530330088001,530330088001,"Block Group 1, Census Tract 88, King County, Washington",558,79,68,55,44,46,24,30,490,83,40,32,450,79
1500000US530330088002,530330088002,"Block Group 2, Census Tract 88, King County, Washington",512,84,35,28,19,22,16,17,477,88,103,64,374,82
1500000US530330088003,530330088003,"Block Group 3, Census Tract 88, King County, Washington",379,78,57,49,18,29,39,40,322,80,40,38,282,76
1500000US530330089001,530330089001,"Block Group 1, Census Tract 89, King County, Washington",616,155,8,14,8,14,0,12,608,155,62,40,546,162
1500000US530330089002,530330089002,"Block Group 2, Census Tract 89, King County, Washington",405,110,0,12,0,12,0,12,405,110,48,45,357,108
1500000US530330089003,530330089003,"Block Group 3, Census Tract 89, King County, Washington",622,187,187,125,172,132,15,25,435,159,21,32,414,156
1500000US530330089004,530330089004,"Block Group 4, Census Tract 89, King County, Washington",409,123,62,57,62,57,0,12,347,122,0,12,347,122
1500000US530330090001,530330090001,"Block Group 1, Census Tract 90, King County, Washington",680,108,49,32,22,25,27,25,631,108,178,78,453,95
1500000US530330090002,530330090002,"Block Group 2, Census Tract 90, King County, Washington",1052,104,276,85,143,71,133,71,776,111,121,47,655,111
1500000US530330091001,530330091001,"Block Group 1, Census Tract 91, King County, Washington",543,96,227,72,87,61,140,51,316,71,35,23,281,72
1500000US530330091002,530330091002,"Block Group 2, Census Tract 91, King County, Washington",777,98,201,82,103,65,98,67,576,99,90,61,486,94
1500000US530330092001,530330092001,"Block Group 1, Census Tract 92, King County, Washington",1002,134,362,98,175,58,187,92,640,133,107,66,533,132
1500000US530330092002,530330092002,"Block Group 2, Census Tract 92, King County, Washington",733,113,342,120,242,107,100,57,391,90,47,30,344,82
1500000US530330093001,530330093001,"Block Group 1, Census Tract 93, King County, Washington",444,65,56,41,17,20,39,38,388,72,51,29,337,73
1500000US530330093002,530330093002,"Block Group 2, Census Tract 93, King County, Washington",97,28,9,14,0,12,9,14,88,29,5,8,83,31
1500000US530330093003,530330093003,"Block Group 3, Census Tract 93, King County, Washington",426,73,71,30,50,34,21,21,355,75,60,39,295,77
1500000US530330094001,530330094001,"Block Group 1, Census Tract 94, King County, Washington",592,136,203,100,89,77,114,102,389,117,31,34,358,116
1500000US530330094002,530330094002,"Block Group 2, Census Tract 94, King County, Washington",704,123,226,90,76,57,150,77,478,110,40,50,438,103
1500000US530330094003,530330094003,"Block Group 3, Census Tract 94, King County, Washington",354,87,91,72,36,33,55,63,263,84,34,41,229,86
1500000US530330094004,530330094004,"Block Group 4, Census Tract 94, King County, Washington",260,100,14,24,14,24,0,12,246,103,9,14,237,105
1500000US530330094005,530330094005,"Block Group 5, Census Tract 94, King County, Washington",582,129,137,107,43,58,94,95,445,136,11,19,434,136
1500000US530330095001,530330095001,"Block Group 1, Census Tract 95, King County, Washington",674,127,11,17,11,17,0,12,663,127,175,121,488,88
1500000US530330095002,530330095002,"Block Group 2, Census Tract 95, King County, Washington",941,142,265,135,130,93,135,107,676,146,119,85,557,149
1500000US530330095003,530330095003,"Block Group 3, Census Tract 95, King County, Washington",480,70,16,25,16,25,0,12,464,73,0,12,464,73
1500000US530330095004,530330095004,"Block Group 4, Census Tract 95, King County, Washington",401,89,101,65,74,62,27,33,300,87,33,34,267,84
1500000US530330096001,530330096001,"Block Group 1, Census Tract 96, King County, Washington",259,79,16,26,0,12,16,26,243,76,53,64,190,75
1500000US530330096002,530330096002,"Block Group 2, Census Tract 96, King County, Washington",793,138,35,40,13,21,22,34,758,143,171,85,587,140
1500000US530330096003,530330096003,"Block Group 3, Census Tract 96, King County, Washington",590,125,15,24,15,24,0,12,575,122,44,41,531,129
1500000US530330096004,530330096004,"Block Group 4, Census Tract 96, King County, Washington",439,96,0,12,0,12,0,12,439,96,79,81,360,97
1500000US530330096005,530330096005,"Block Group 5, Census Tract 96, King County, Washington",691,134,36,58,0,12,36,58,655,124,31,50,624,126
1500000US530330097011,530330097011,"Block Group 1, Census Tract 97.01, King County, Washington",941,149,17,27,0,12,17,27,924,150,126,75,798,152
1500000US530330097012,530330097012,"Block Group 2, Census Tract 97.01, King County, Washington",611,128,65,58,29,32,36,47,546,136,78,67,468,139
1500000US530330097013,530330097013,"Block Group 3, Census Tract 97.01, King County, Washington",639,105,18,28,0,12,18,28,621,108,170,99,451,112
1500000US530330097014,530330097014,"Block Group 4, Census Tract 97.01, King County, Washington",755,138,28,34,28,34,0,12,727,141,125,98,602,139
1500000US530330097021,530330097021,"Block Group 1, Census Tract 97.02, King County, Washington",578,93,12,20,0,12,12,20,566,94,88,49,478,93
1500000US530330097022,530330097022,"Block Group 2, Census Tract 97.02, King County, Washington",398,69,15,26,15,26,0,12,383,70,77,57,306,83
1500000US530330097023,530330097023,"Block Group 3, Census Tract 97.02, King County, Washington",321,87,49,73,0,12,49,73,272,62,39,34,233,65
1500000US530330097024,530330097024,"Block Group 4, Census Tract 97.02, King County, Washington",401,64,14,21,0,12,14,21,387,64,39,35,348,70
1500000US530330097025,530330097025,"Block Group 5, Census Tract 97.02, King County, Washington",503,87,24,27,0,12,24,27,479,90,81,42,398,92
1500000US530330098001,530330098001,"Block Group 1, Census Tract 98, King County, Washington",527,103,13,22,13,22,0,12,514,106,20,32,494,103
1500000US530330098002,530330098002,"Block Group 2, Census Tract 98, King County, Washington",583,94,19,28,0,12,19,28,564,91,119,74,445,102
1500000US530330098003,530330098003,"Block Group 3, Census Tract 98, King County, Washington",572,74,19,29,19,29,0,12,553,80,65,57,488,76
1500000US530330098004,530330098004,"Block Group 4, Census Tract 98, King County, Washington",617,116,29,36,0,12,29,36,588,116,52,50,536,125
1500000US530330098005,530330098005,"Block Group 5, Census Tract 98, King County, Washington",668,131,11,18,11,18,0,12,657,130,65,79,592,116
1500000US530330099001,530330099001,"Block Group 1, Census Tract 99, King County, Washington",535,110,61,74,0,12,61,74,474,80,66,51,408,96
1500000US530330099002,530330099002,"Block Group 2, Census Tract 99, King County, Washington",707,131,0,12,0,12,0,12,707,131,71,54,636,130
1500000US530330099003,530330099003,"Block Group 3, Census Tract 99, King County, Washington",757,142,71,51,30,33,41,40,686,139,86,56,600,142
1500000US530330099004,530330099004,"Block Group 4, Census Tract 99, King County, Washington",467,127,0,12,0,12,0,12,467,127,48,46,419,126
1500000US530330100011,530330100011,"Block Group 1, Census Tract 100.01, King County, Washington",340,79,29,33,11,19,18,28,311,79,56,46,255,88
1500000US530330100012,530330100012,"Block Group 2, Census Tract 100.01, King County, Washington",522,108,26,28,6,12,20,23,496,110,0,12,496,110
1500000US530330100013,530330100013,"Block Group 3, Census Tract 100.01, King County, Washington",695,100,227,113,129,71,98,82,468,107,105,70,363,93
1500000US530330100021,530330100021,"Block Group 1, Census Tract 100.02, King County, Washington",392,90,24,33,0,12,24,33,368,93,59,47,309,97
1500000US530330100022,530330100022,"Block Group 2, Census Tract 100.02, King County, Washington",557,83,102,62,16,27,86,60,455,88,101,70,354,91
1500000US530330100023,530330100023,"Block Group 3, Census Tract 100.02, King County, Washington",290,63,20,22,12,19,8,14,270,60,49,38,221,61
1500000US530330100024,530330100024,"Block Group 4, Census Tract 100.02, King County, Washington",459,83,55,49,32,36,23,34,404,80,103,55,301,87
1500000US530330101001,530330101001,"Block Group 1, Census Tract 101, King County, Washington",434,90,54,86,54,86,0,12,380,85,17,28,363,81
1500000US530330101002,530330101002,"Block Group 2, Census Tract 101, King County, Washington",423,113,55,85,0,12,55,85,368,91,62,44,306,92
1500000US530330101003,530330101003,"Block Group 3, Census Tract 101, King County, Washington",294,110,104,52,61,49,43,36,190,94,32,35,158,94
1500000US530330101004,530330101004,"Block Group 4, Census Tract 101, King County, Washington",810,148,142,93,38,43,104,85,668,169,191,115,477,168
1500000US530330101005,530330101005,"Block Group 5, Census Tract 101, King County, Washington",778,119,197,102,123,89,74,76,581,124,50,41,531,121
1500000US530330102001,530330102001,"Block Group 1, Census Tract 102, King County, Washington",554,74,0,12,0,12,0,12,554,74,80,43,474,83
1500000US530330102002,530330102002,"Block Group 2, Census Tract 102, King County, Washington",465,52,0,12,0,12,0,12,465,52,83,49,382,62
1500000US530330102003,530330102003,"Block Group 3, Census Tract 102, King County, Washington",372,68,47,29,23,17,24,22,325,71,59,44,266,65
1500000US530330102004,530330102004,"Block Group 4, Census Tract 102, King County, Washington",482,62,11,12,11,12,0,12,471,63,31,26,440,66
1500000US530330103001,530330103001,"Block Group 1, Census Tract 103, King County, Washington",400,112,58,93,0,12,58,93,342,86,26,29,316,88
1500000US530330103002,530330103002,"Block Group 2, Census Tract 103, King County, Washington",461,121,101,55,69,47,32,36,360,122,35,40,325,128
1500000US530330103003,530330103003,"Block Group 3, Census Tract 103, King County, Washington",490,135,159,99,47,47,112,92,331,113,51,42,280,113
1500000US530330103004,530330103004,"Block Group 4, Census Tract 103, King County, Washington",525,128,232,121,92,94,140,109,293,124,12,19,281,124
1500000US530330103005,530330103005,"Block Group 5, Census Tract 103, King County, Washington",627,148,67,49,30,35,37,34,560,151,10,13,550,150
1500000US530330104011,530330104011,"Block Group 1, Census Tract 104.01, King County, Washington",469,78,28,38,25,37,3,7,441,85,43,48,398,85
1500000US530330104012,530330104012,"Block Group 2, Census Tract 104.01, King County, Washington",595,103,193,97,59,51,134,83,402,83,72,47,330,80
1500000US530330104013,530330104013,"Block Group 3, Census Tract 104.01, King County, Washington",388,89,76,55,28,31,48,45,312,87,57,39,255,83
1500000US530330104021,530330104021,"Block Group 1, Census Tract 104.02, King County, Washington",320,83,17,21,10,16,7,13,303,81,51,38,252,79
1500000US530330104022,530330104022,"Block Group 2, Census Tract 104.02, King County, Washington",382,93,32,22,0,12,32,22,350,95,115,86,235,73
1500000US530330104023,530330104023,"Block Group 3, Census Tract 104.02, King County, Washington",377,99,74,63,27,44,47,44,303,86,58,45,245,84
1500000US530330104024,530330104024,"Block Group 4, Census Tract 104.02, King County, Washington",453,96,11,17,0,12,11,17,442,97,44,33,398,99
1500000US530330105001,530330105001,"Block Group 1, Census Tract 105, King County, Washington",461,109,12,19,0,12,12,19,449,112,153,81,296,82
1500000US530330105002,530330105002,"Block Group 2, Census Tract 105, King County, Washington",724,120,62,79,44,73,18,29,662,112,15,23,647,112
1500000US530330105003,530330105003,"Block Group 3, Census Tract 105, King County, Washington",431,90,16,27,0,12,16,27,415,88,51,36,364,89
1500000US530330105004,530330105004,"Block Group 4, Census Tract 105, King County, Washington",1014,154,90,73,65,65,25,29,924,147,89,59,835,147
1500000US530330105005,530330105005,"Block Group 5, Census Tract 105, King County, Washington",726,117,66,72,54,69,12,20,660,108,99,60,561,127
1500000US530330106001,530330106001,"Block Group 1, Census Tract 106, King County, Washington",632,104,13,20,0,12,13,20,619,108,67,61,552,97
1500000US530330106002,530330106002,"Block Group 2, Census Tract 106, King County, Washington",551,117,59,73,0,12,59,73,492,104,17,27,475,103
1500000US530330106003,530330106003,"Block Group 3, Census Tract 106, King County, Washington",786,118,116,81,33,51,83,64,670,101,68,44,602,104
1500000US530330106004,530330106004,"Block Group 4, Census Tract 106, King County, Washington",418,96,0,12,0,12,0,12,418,96,49,48,369,98
1500000US530330106005,530330106005,"Block Group 5, Census Tract 106, King County, Washington",706,102,28,43,28,43,0,12,678,104,151,68,527,98
1500000US530330106006,530330106006,"Block Group 6, Census Tract 106, King County, Washington",444,64,57,45,29,33,28,30,387,67,12,19,375,69
1500000US530330107011,530330107011,"Block Group 1, Census Tract 107.01, King County, Washington",956,141,362,139,122,90,240,131,594,140,38,42,556,133
1500000US530330107012,530330107012,"Block Group 2, Census Tract 107.01, King County, Washington",459,114,116,74,20,32,96,75,343,95,44,37,299,97
1500000US530330107021,530330107021,"Block Group 1, Census Tract 107.02, King County, Washington",459,73,37,39,37,39,0,12,422,66,8,12,414,66
1500000US530330107022,530330107022,"Block Group 2, Census Tract 107.02, King County, Washington",461,90,188,71,115,59,73,53,273,100,67,53,206,94
1500000US530330107023,530330107023,"Block Group 3, Census Tract 107.02, King County, Washington",526,94,248,83,80,56,168,68,278,81,47,45,231,69
1500000US530330108001,530330108001,"Block Group 1, Census Tract 108, King County, Washington",480,74,117,52,54,33,63,48,363,75,42,28,321,78
1500000US530330108002,530330108002,"Block Group 2, Census Tract 108, King County, Washington",477,79,135,68,30,35,105,58,342,71,54,40,288,72
1500000US530330108003,530330108003,"Block Group 3, Census Tract 108, King County, Washington",769,97,106,67,58,47,48,45,663,112,65,38,598,116
1500000US530330109001,530330109001,"Block Group 1, Census Tract 109, King County, Washington",342,67,60,46,35,40,25,25,282,66,42,34,240,66
1500000US530330109002,530330109002,"Block Group 2, Census Tract 109, King County, Washington",267,64,49,31,36,27,13,15,218,68,22,22,196,66
1500000US530330110011,530330110011,"Block Group 1, Census Tract 110.01, King County, Washington",385,93,145,63,75,69,70,43,240,74,9,16,231,72
1500000US530330110012,530330110012,"Block Group 2, Census Tract 110.01, King County, Washington",390,86,93,62,63,50,30,45,297,79,137,61,160,73
1500000US530330110013,530330110013,"Block Group 3, Census Tract 110.01, King County, Washington",813,111,398,109,223,90,175,75,415,119,36,32,379,123
1500000US530330110021,530330110021,"Block Group 1, Census Tract 110.02, King County, Washington",234,73,28,28,7,12,21,26,206,65,37,27,169,67
1500000US530330110022,530330110022,"Block Group 2, Census Tract 110.02, King County, Washington",697,83,333,105,52,45,281,99,364,86,59,46,305,80
1500000US530330110023,530330110023,"Block Group 3, Census Tract 110.02, King County, Washington",340,82,74,64,32,49,42,47,266,88,70,40,196,81
1500000US530330111011,530330111011,"Block Group 1, Census Tract 111.01, King County, Washington",366,76,201,79,142,74,59,43,165,68,47,28,118,61
1500000US530330111012,530330111012,"Block Group 2, Census Tract 111.01, King County, Washington",567,123,192,107,108,87,84,65,375,99,42,34,333,98
1500000US530330111013,530330111013,"Block Group 3, Census Tract 111.01, King County, Washington",353,92,45,36,11,16,34,32,308,99,24,22,284,97
1500000US530330111014,530330111014,"Block Group 4, Census Tract 111.01, King County, Washington",437,88,87,44,41,32,46,44,350,83,81,46,269,83
1500000US530330111021,530330111021,"Block Group 1, Census Tract 111.02, King County, Washington",418,61,0,12,0,12,0,12,418,61,111,51,307,68
1500000US530330111022,530330111022,"Block Group 2, Census Tract 111.02, King County, Washington",382,86,77,54,77,54,0,12,305,80,62,49,243,73
1500000US530330111023,530330111023,"Block Group 3, Census Tract 111.02, King County, Washington",316,101,72,53,17,20,55,50,244,108,45,44,199,95
1500000US530330111024,530330111024,"Block Group 4, Census Tract 111.02, King County, Washington",298,75,36,35,30,32,6,12,262,71,7,11,255,72
1500000US530330112001,530330112001,"Block Group 1, Census Tract 112, King County, Washington",565,83,201,75,109,58,92,58,364,97,63,46,301,97
1500000US530330112002,530330112002,"Block Group 2, Census Tract 112, King County, Washington",316,79,8,11,8,11,0,12,308,81,123,74,185,62
1500000US530330112003,530330112003,"Block Group 3, Census Tract 112, King County, Washington",516,92,183,94,55,47,128,84,333,77,53,48,280,75
1500000US530330113001,530330113001,"Block Group 1, Census Tract 113, King County, Washington",1299,139,293,128,220,114,73,65,1006,132,339,139,667,139
1500000US530330113002,530330113002,"Block Group 2, Census Tract 113, King County, Washington",339,97,63,67,41,61,22,36,276,86,18,29,258,84
1500000US530330113003,530330113003,"Block Group 3, Census Tract 113, King County, Washington",345,100,33,40,21,34,12,20,312,97,53,44,259,96
1500000US530330113004,530330113004,"Block Group 4, Census Tract 113, King County, Washington",498,125,57,72,17,35,40,62,441,116,92,90,349,118
1500000US530330113005,530330113005,"Block Group 5, Census Tract 113, King County, Washington",374,87,40,41,0,12,40,41,334,87,44,34,290,88
1500000US530330114011,530330114011,"Block Group 1, Census Tract 114.01, King County, Washington",645,113,125,79,57,75,68,69,520,105,86,63,434,94
1500000US530330114012,530330114012,"Block Group 2, Census Tract 114.01, King County, Washington",549,119,77,54,25,28,52,47,472,116,53,41,419,117
1500000US530330114013,530330114013,"Block Group 3, Census Tract 114.01, King County, Washington",514,74,44,27,15,17,29,22,470,79,69,54,401,80
1500000US530330114021,530330114021,"Block Group 1, Census Tract 114.02, King County, Washington",588,96,61,41,38,34,23,22,527,100,93,46,434,110
1500000US530330114022,530330114022,"Block Group 2, Census Tract 114.02, King County, Washington",605,110,195,87,47,40,148,86,410,98,80,54,330,103
1500000US530330114023,530330114023,"Block Group 3, Census Tract 114.02, King County, Washington",698,86,254,74,106,61,148,66,444,93,153,63,291,78
1500000US530330115001,530330115001,"Block Group 1, Census Tract 115, King County, Washington",507,67,55,30,22,20,33,28,452,75,94,42,358,80
1500000US530330115002,530330115002,"Block Group 2, Census Tract 115, King County, Washington",616,63,17,20,10,16,7,13,599,64,49,35,550,67
1500000US530330115003,530330115003,"Block Group 3, Census Tract 115, King County, Washington",811,77,70,54,23,27,47,46,741,84,116,62,625,90
1500000US530330116001,530330116001,"Block Group 1, Census Tract 116, King County, Washington",543,109,0,12,0,12,0,12,543,109,54,49,489,116
1500000US530330116002,530330116002,"Block Group 2, Census Tract 116, King County, Washington",549,92,14,22,14,22,0,12,535,97,3,13,532,97
1500000US530330116003,530330116003,"Block Group 3, Census Tract 116, King County, Washington",625,105,0,12,0,12,0,12,625,105,112,65,513,126
1500000US530330116004,530330116004,"Block Group 4, Census Tract 116, King County, Washington",373,70,0,12,0,12,0,12,373,70,43,39,330,79
1500000US530330116005,530330116005,"Block Group 5, Census Tract 116, King County, Washington",425,76,0,12,0,12,0,12,425,76,12,21,413,79
1500000US530330116006,530330116006,"Block Group 6, Census Tract 116, King County, Washington",433,99,10,17,10,17,0,12,423,102,55,51,368,98
1500000US530330117001,530330117001,"Block Group 1, Census Tract 117, King County, Washington",388,73,117,70,23,27,94,63,271,73,62,38,209,73
1500000US530330117002,530330117002,"Block Group 2, Census Tract 117, King County, Washington",435,82,97,53,55,40,42,41,338,87,89,57,249,90
1500000US530330117003,530330117003,"Block Group 3, Census Tract 117, King County, Washington",539,90,116,80,78,76,38,31,423,92,100,45,323,100
1500000US530330117004,530330117004,"Block Group 4, Census Tract 117, King County, Washington",285,73,41,31,17,20,24,24,244,83,64,37,180,78
1500000US530330118001,530330118001,"Block Group 1, Census Tract 118, King County, Washington",442,122,21,33,0,12,21,33,421,124,127,101,294,101
1500000US530330118002,530330118002,"Block Group 2, Census Tract 118, King County, Washington",342,120,31,36,16,25,15,24,311,118,96,108,215,91
1500000US530330118003,530330118003,"Block Group 3, Census Tract 118, King County, Washington",322,103,30,34,15,25,15,24,292,102,13,21,279,107
1500000US530330118004,530330118004,"Block Group 4, Census Tract 118, King County, Washington",565,138,297,119,90,65,207,123,268,115,73,70,195,109
1500000US530330118005,530330118005,"Block Group 5, Census Tract 118, King County, Washington",473,111,173,97,151,96,22,28,300,111,68,57,232,105
1500000US530330118006,530330118006,"Block Group 6, Census Tract 118, King County, Washington",614,138,288,130,108,64,180,113,326,141,92,83,234,122
1500000US530330119001,530330119001,"Block Group 1, Census Tract 119, King County, Washington",602,121,23,31,23,31,0,12,579,121,123,59,456,124
1500000US530330119002,530330119002,"Block Group 2, Census Tract 119, King County, Washington",510,105,63,63,0,12,63,63,447,112,64,45,383,113
1500000US530330119003,530330119003,"Block Group 3, Census Tract 119, King County, Washington",475,101,98,91,23,41,75,85,377,111,120,71,257,113
1500000US530330119004,530330119004,"Block Group 4, Census Tract 119, King County, Washington",399,119,223,102,130,101,93,81,176,84,41,37,135,78
1500000US530330119005,530330119005,"Block Group 5, Census Tract 119, King County, Washington",467,132,56,54,56,54,0,12,411,142,66,61,345,140
1500000US530330120001,530330120001,"Block Group 1, Census Tract 120, King County, Washington",478,79,85,59,60,51,25,28,393,68,65,49,328,65
1500000US530330120002,530330120002,"Block Group 2, Census Tract 120, King County, Washington",453,89,12,18,12,18,0,12,441,90,13,15,428,91
1500000US530330120003,530330120003,"Block Group 3, Census Tract 120, King County, Washington",520,82,15,18,15,18,0,12,505,83,44,37,461,90
1500000US530330121001,530330121001,"Block Group 1, Census Tract 121, King County, Washington",457,54,0,12,0,12,0,12,457,54,38,31,419,54
1500000US530330121002,530330121002,"Block Group 2, Census Tract 121, King County, Washington",684,58,37,26,10,17,27,20,647,63,132,46,515,79
1500000US530330201001,530330201001,"Block Group 1, Census Tract 201, King County, Washington",483,49,19,21,7,12,12,18,464,52,42,30,422,54
1500000US530330201002,530330201002,"Block Group 2, Census Tract 201, King County, Washington",380,54,20,23,9,14,11,18,360,57,82,45,278,54
1500000US530330201003,530330201003,"Block Group 3, Census Tract 201, King County, Washington",387,53,16,19,0,12,16,19,371,52,70,44,301,65
1500000US530330202001,530330202001,"Block Group 1, Census Tract 202, King County, Washington",380,86,35,38,16,25,19,29,345,86,41,28,304,93
1500000US530330202002,530330202002,"Block Group 2, Census Tract 202, King County, Washington",588,108,12,21,12,21,0,12,576,111,239,85,337,92
1500000US530330202003,530330202003,"Block Group 3, Census Tract 202, King County, Washington",353,74,67,64,67,64,0,12,286,70,48,38,238,75
1500000US530330202004,530330202004,"Block Group 4, Census Tract 202, King County, Washington",383,88,11,19,0,12,11,19,372,91,70,63,302,80
1500000US530330202005,530330202005,"Block Group 5, Census Tract 202, King County, Washington",402,74,0,12,0,12,0,12,402,74,74,50,328,75
1500000US530330203001,530330203001,"Block Group 1, Census Tract 203, King County, Washington",661,125,58,59,16,25,42,53,603,110,50,35,553,122
1500000US530330203002,530330203002,"Block Group 2, Census Tract 203, King County, Washington",376,92,9,16,9,16,0,12,367,92,75,50,292,92
1500000US530330203003,530330203003,"Block Group 3, Census Tract 203, King County, Washington",396,84,33,30,17,17,16,27,363,93,112,46,251,99
1500000US530330203004,530330203004,"Block Group 4, Census Tract 203, King County, Washington",428,99,69,58,16,25,53,51,359,94,47,43,312,86
1500000US530330203005,530330203005,"Block Group 5, Census Tract 203, King County, Washington",1007,168,232,105,118,67,114,91,775,178,136,67,639,178
1500000US530330204011,530330204011,"Block Group 1, Census Tract 204.01, King County, Washington",803,83,99,62,49,39,50,56,704,95,124,69,580,103
1500000US530330204012,530330204012,"Block Group 2, Census Tract 204.01, King County, Washington",312,61,0,12,0,12,0,12,312,61,74,45,238,54
1500000US530330204013,530330204013,"Block Group 3, Census Tract 204.01, King County, Washington",234,48,31,25,17,19,14,17,203,47,40,32,163,43
1500000US530330204021,530330204021,"Block Group 1, Census Tract 204.02, King County, Washington",553,113,44,42,0,12,44,42,509,115,191,112,318,81
1500000US530330204022,530330204022,"Block Group 2, Census Tract 204.02, King County, Washington",441,88,0,12,0,12,0,12,441,88,104,71,337,79
1500000US530330204023,530330204023,"Block Group 3, Census Tract 204.02, King County, Washington",235,74,35,41,35,41,0,12,200,79,32,37,168,89
1500000US530330204024,530330204024,"Block Group 4, Census Tract 204.02, King County, Washington",416,81,0,12,0,12,0,12,416,81,28,32,388,86
1500000US530330204025,530330204025,"Block Group 5, Census Tract 204.02, King County, Washington",565,105,89,42,47,36,42,42,476,105,46,40,430,108
1500000US530330205001,530330205001,"Block Group 1, Census Tract 205, King County, Washington",807,133,146,67,110,62,36,34,661,140,26,28,635,139
1500000US530330205002,530330205002,"Block Group 2, Census Tract 205, King County, Washington",506,113,53,67,53,67,0,12,453,131,100,96,353,106
1500000US530330205003,530330205003,"Block Group 3, Census Tract 205, King County, Washington",532,94,15,23,15,23,0,12,517,93,92,82,425,94
1500000US530330205004,530330205004,"Block Group 4, Census Tract 205, King County, Washington",244,67,0,12,0,12,0,12,244,67,78,54,166,61
1500000US530330205005,530330205005,"Block Group 5, Census Tract 205, King County, Washington",296,96,12,20,12,20,0,12,284,97,28,33,256,110
1500000US530330205006,530330205006,"Block Group 6, Census Tract 205, King County, Washington",287,73,13,21,13,21,0,12,274,74,79,38,195,77
1500000US530330206001,530330206001,"Block Group 1, Census Tract 206, King County, Washington",307,55,9,14,4,9,5,9,298,56,45,29,253,61
1500000US530330206002,530330206002,"Block Group 2, Census Tract 206, King County, Washington",361,65,72,49,46,44,26,19,289,65,58,31,231,60
1500000US530330206003,530330206003,"Block Group 3, Census Tract 206, King County, Washington",294,59,14,19,14,19,0,12,280,61,7,11,273,62
1500000US530330206004,530330206004,"Block Group 4, Census Tract 206, King County, Washington",309,61,17,19,9,13,8,14,292,65,110,59,182,39
1500000US530330207001,530330207001,"Block Group 1, Census Tract 207, King County, Washington",481,70,101,71,67,68,34,27,380,60,55,34,325,61
1500000US530330207002,530330207002,"Block Group 2, Census Tract 207, King County, Washington",549,77,224,72,166,66,58,40,325,73,76,44,249,71
1500000US530330207003,530330207003,"Block Group 3, Census Tract 207, King County, Washington",449,85,12,19,0,12,12,19,437,86,115,62,322,83
1500000US530330208001,530330208001,"Block Group 1, Census Tract 208, King County, Washington",560,89,71,67,19,22,52,61,489,107,88,44,401,110
1500000US530330208002,530330208002,"Block Group 2, Census Tract 208, King County, Washington",444,84,54,40,6,10,48,39,390,89,24,23,366,92
1500000US530330208003,530330208003,"Block Group 3, Census Tract 208, King County, Washington",363,46,20,22,10,15,10,16,343,51,26,23,317,54
1500000US530330208004,530330208004,"Block Group 4, Census Tract 208, King County, Washington",327,61,7,10,7,10,0,12,320,60,52,30,268,66
1500000US530330209001,530330209001,"Block Group 1, Census Tract 209, King County, Washington",591,94,95,62,7,12,88,60,496,92,120,46,376,84
1500000US530330209002,530330209002,"Block Group 2, Census Tract 209, King County, Washington",424,66,83,34,59,34,24,19,341,72,46,31,295,77
1500000US530330209003,530330209003,"Block Group 3, Census Tract 209, King County, Washington",384,77,46,29,14,16,32,31,338,80,24,21,314,78
1500000US530330210001,530330210001,"Block Group 1, Census Tract 210, King County, Washington",267,55,23,39,0,12,23,39,244,51,59,43,185,62
1500000US530330210002,530330210002,"Block Group 2, Census Tract 210, King County, Washington",463,115,0,12,0,12,0,12,463,115,98,45,365,112
1500000US530330210003,530330210003,"Block Group 3, Census Tract 210, King County, Washington",548,126,43,55,10,18,33,53,505,126,41,40,464,129
1500000US530330210004,530330210004,"Block Group 4, Census Tract 210, King County, Washington",605,112,17,33,7,22,10,18,588,119,132,94,456,103
1500000US530330210005,530330210005,"Block Group 5, Census Tract 210, King County, Washington",277,106,29,72,16,24,13,64,248,97,57,40,191,92
1500000US530330211001,530330211001,"Block Group 1, Census Tract 211, King County, Washington",603,88,87,62,44,46,43,43,516,92,71,42,445,89
1500000US530330211002,530330211002,"Block Group 2, Census Tract 211, King County, Washington",457,80,89,65,65,55,24,37,368,58,112,67,256,69
1500000US530330211003,530330211003,"Block Group 3, Census Tract 211, King County, Washington",533,81,149,68,96,55,53,36,384,79,49,31,335,75
1500000US530330211004,530330211004,"Block Group 4, Census Tract 211, King County, Washington",0,12,0,12,0,12,0,12,0,12,0,12,0,12
1500000US530330213001,530330213001,"Block Group 1, Census Tract 213, King County, Washington",684,83,50,38,12,20,38,31,634,87,110,47,524,91
1500000US530330213002,530330213002,"Block Group 2, Census Tract 213, King County, Washington",491,88,48,36,17,25,31,25,443,89,74,60,369,83
1500000US530330213003,530330213003,"Block Group 3, Census Tract 213, King County, Washington",527,80,89,54,44,43,45,34,438,78,33,26,405,80
1500000US530330214001,530330214001,"Block Group 1, Census Tract 214, King County, Washington",372,73,29,21,12,19,17,18,343,74,114,51,229,69
1500000US530330214002,530330214002,"Block Group 2, Census Tract 214, King County, Washington",595,74,59,53,44,50,15,17,536,71,99,48,437,77
1500000US530330214003,530330214003,"Block Group 3, Census Tract 214, King County, Washington",475,75,14,21,14,21,0,12,461,78,44,29,417,80
1500000US530330215001,530330215001,"Block Group 1, Census Tract 215, King County, Washington",345,63,0,12,0,12,0,12,345,63,77,46,268,68
1500000US530330215002,530330215002,"Block Group 2, Census Tract 215, King County, Washington",340,52,0,12,0,12,0,12,340,52,48,22,292,55
1500000US530330215003,530330215003,"Block Group 3, Census Tract 215, King County, Washington",624,83,0,12,0,12,0,12,624,83,133,61,491,81
1500000US530330215004,530330215004,"Block Group 4, Census Tract 215, King County, Washington",390,69,9,14,9,14,0,12,381,73,75,60,306,60
1500000US530330216001,530330216001,"Block Group 1, Census Tract 216, King County, Washington",514,72,42,27,16,18,26,23,472,72,96,52,376,75
1500000US530330216002,530330216002,"Block Group 2, Census Tract 216, King County, Washington",372,80,23,25,0,12,23,25,349,79,86,50,263,69
1500000US530330216003,530330216003,"Block Group 3, Census Tract 216, King County, Washington",530,83,73,42,10,15,63,39,457,78,79,31,378,82
1500000US530330216004,530330216004,"Block Group 4, Census Tract 216, King County, Washington",346,48,58,48,10,15,48,47,288,58,67,35,221,56
1500000US530330217001,530330217001,"Block Group 1, Census Tract 217, King County, Washington",513,120,76,81,29,33,47,74,437,110,122,77,315,106
1500000US530330217002,530330217002,"Block Group 2, Census Tract 217, King County, Washington",581,111,36,39,0,12,36,39,545,100,58,52,487,103
1500000US530330217003,530330217003,"Block Group 3, Census Tract 217, King County, Washington",463,76,16,25,16,25,0,12,447,80,130,71,317,80
1500000US530330217004,530330217004,"Block Group 4, Census Tract 217, King County, Washington",831,142,165,74,94,52,71,54,666,145,291,136,375,106
1500000US530330217005,530330217005,"Block Group 5, Census Tract 217, King County, Washington",929,151,99,56,23,26,76,50,830,146,103,59,727,152
1500000US530330218021,530330218021,"Block Group 1, Census Tract 218.02, King County, Washington",693,113,51,60,0,12,51,60,642,117,87,66,555,119
1500000US530330218022,530330218022,"Block Group 2, Census Tract 218.02, King County, Washington",961,132,123,98,96,94,27,42,838,133,109,82,729,127
1500000US530330218023,530330218023,"Block Group 3, Census Tract 218.02, King County, Washington",514,87,8,15,8,15,0,12,506,91,39,43,467,98
1500000US530330218031,530330218031,"Block Group 1, Census Tract 218.03, King County, Washington",591,86,134,76,28,30,106,74,457,71,110,68,347,78
1500000US530330218032,530330218032,"Block Group 2, Census Tract 218.03, King County, Washington",325,75,61,42,51,40,10,15,264,76,98,71,166,59
1500000US530330218033,530330218033,"Block Group 3, Census Tract 218.03, King County, Washington",522,74,22,25,15,23,7,12,500,74,86,54,414,81
1500000US530330218034,530330218034,"Block Group 4, Census Tract 218.03, King County, Washington",423,60,58,56,0,12,58,56,365,63,82,41,283,64
1500000US530330218041,530330218041,"Block Group 1, Census Tract 218.04, King County, Washington",631,88,31,48,31,48,0,12,600,85,96,52,504,82
1500000US530330218042,530330218042,"Block Group 2, Census Tract 218.04, King County, Washington",533,100,52,33,23,24,29,22,481,100,101,57,380,90
1500000US530330218043,530330218043,"Block Group 3, Census Tract 218.04, King County, Washington",464,81,52,46,26,21,26,43,412,79,29,21,383,77
1500000US530330219031,530330219031,"Block Group 1, Census Tract 219.03, King County, Washington",849,154,37,42,17,26,20,32,812,150,166,84,646,149
1500000US530330219032,530330219032,"Block Group 2, Census Tract 219.03, King County, Washington",347,63,0,12,0,12,0,12,347,63,92,53,255,64
1500000US530330219033,530330219033,"Block Group 3, Census Tract 219.03, King County, Washington",272,61,16,26,16,26,0,12,256,66,52,44,204,68
1500000US530330219034,530330219034,"Block Group 4, Census Tract 219.03, King County, Washington",228,50,24,40,0,12,24,40,204,59,31,38,173,71
1500000US530330219035,530330219035,"Block Group 5, Census Tract 219.03, King County, Washington",595,117,0,12,0,12,0,12,595,117,79,52,516,123
1500000US530330219041,530330219041,"Block Group 1, Census Tract 219.04, King County, Washington",658,80,152,68,101,70,51,35,506,83,45,29,461,81
1500000US530330219042,530330219042,"Block Group 2, Census Tract 219.04, King County, Washington",271,39,16,17,0,12,16,17,255,40,0,12,255,40
1500000US530330219043,530330219043,"Block Group 3, Census Tract 219.04, King County, Washington",502,71,31,42,0,12,31,42,471,75,120,61,351,76
1500000US530330219044,530330219044,"Block Group 4, Census Tract 219.04, King County, Washington",352,78,5,9,0,12,5,9,347,78,26,24,321,80
1500000US530330219051,530330219051,"Block Group 1, Census Tract 219.05, King County, Washington",745,128,18,28,18,28,0,12,727,130,32,25,695,131
1500000US530330219052,530330219052,"Block Group 2, Census Tract 219.05, King County, Washington",447,71,9,16,0,12,9,16,438,74,94,59,344,83
1500000US530330219053,530330219053,"Block Group 3, Census Tract 219.05, King County, Washington",498,124,38,35,0,12,38,35,460,135,84,77,376,120
1500000US530330219054,530330219054,"Block Group 4, Census Tract 219.05, King County, Washington",450,104,33,36,0,12,33,36,417,108,123,92,294,110
1500000US530330219061,530330219061,"Block Group 1, Census Tract 219.06, King County, Washington",711,86,11,17,0,12,11,17,700,87,93,55,607,92
1500000US530330219062,530330219062,"Block Group 2, Census Tract 219.06, King County, Washington",260,54,0,12,0,12,0,12,260,54,19,16,241,56
1500000US530330219063,530330219063,"Block Group 3, Census Tract 219.06, King County, Washington",620,93,52,39,22,19,30,34,568,101,43,34,525,98
1500000US530330220011,530330220011,"Block Group 1, Census Tract 220.01, King County, Washington",517,126,40,46,0,12,40,46,477,129,27,32,450,126
1500000US530330220012,530330220012,"Block Group 2, Census Tract 220.01, King County, Washington",1074,130,74,57,39,38,35,40,1000,142,487,128,513,110
1500000US530330220013,530330220013,"Block Group 3, Census Tract 220.01, King County, Washington",516,121,14,20,14,20,0,12,502,120,64,47,438,122
1500000US530330220031,530330220031,"Block Group 1, Census Tract 220.03, King County, Washington",484,82,9,15,9,15,0,12,475,87,117,54,358,84
1500000US530330220032,530330220032,"Block Group 2, Census Tract 220.03, King County, Washington",440,95,6,11,0,12,6,11,434,97,55,41,379,102
1500000US530330220033,530330220033,"Block Group 3, Census Tract 220.03, King County, Washington",367,70,0,12,0,12,0,12,367,70,73,41,294,79
1500000US530330220034,530330220034,"Block Group 4, Census Tract 220.03, King County, Washington",304,57,13,20,13,20,0,12,291,62,32,28,259,64
1500000US530330220035,530330220035,"Block Group 5, Census Tract 220.03, King County, Washington",342,78,27,31,0,12,27,31,315,80,68,60,247,75
1500000US530330220051,530330220051,"Block Group 1, Census Tract 220.05, King County, Washington",878,137,36,41,20,31,16,26,842,138,151,88,691,149
1500000US530330220052,530330220052,"Block Group 2, Census Tract 220.05, King County, Washington",422,125,0,12,0,12,0,12,422,125,91,74,331,104
1500000US530330220053,530330220053,"Block Group 3, Census Tract 220.05, King County, Washington",827,130,12,19,0,12,12,19,815,131,42,45,773,135
1500000US530330220061,530330220061,"Block Group 1, Census Tract 220.06, King County, Washington",555,73,13,21,13,21,0,12,542,76,108,47,434,80
1500000US530330220062,530330220062,"Block Group 2, Census Tract 220.06, King County, Washington",588,94,14,16,0,12,14,16,574,92,70,38,504,100
1500000US530330220063,530330220063,"Block Group 3, Census Tract 220.06, King County, Washington",523,82,87,64,33,32,54,59,436,92,59,35,377,95
1500000US530330221011,530330221011,"Block Group 1, Census Tract 221.01, King County, Washington",537,80,69,40,20,23,49,30,468,71,122,48,346,77
1500000US530330221012,530330221012,"Block Group 2, Census Tract 221.01, King County, Washington",354,54,23,26,0,12,23,26,331,58,25,18,306,58
1500000US530330221013,530330221013,"Block Group 3, Census Tract 221.01, King County, Washington",565,81,49,50,38,47,11,16,516,74,65,39,451,76
1500000US530330221014,530330221014,"Block Group 4, Census Tract 221.01, King County, Washington",308,48,20,15,9,15,11,16,288,49,52,32,236,51
1500000US530330221021,530330221021,"Block Group 1, Census Tract 221.02, King County, Washington",1111,111,54,46,0,12,54,46,1057,115,143,75,914,128
1500000US530330221022,530330221022,"Block Group 2, Census Tract 221.02, King County, Washington",303,68,27,39,27,39,0,12,276,65,33,36,243,61
1500000US530330221023,530330221023,"Block Group 3, Census Tract 221.02, King County, Washington",433,87,15,24,15,24,0,12,418,87,28,31,390,86
1500000US530330221024,530330221024,"Block Group 4, Census Tract 221.02, King County, Washington",457,69,0,12,0,12,0,12,457,69,58,45,399,77
1500000US530330222011,530330222011,"Block Group 1, Census Tract 222.01, King County, Washington",373,65,69,64,10,16,59,62,304,61,60,35,244,67
1500000US530330222012,530330222012,"Block Group 2, Census Tract 222.01, King County, Washington",251,55,8,16,0,12,8,16,243,58,49,35,194,61
1500000US530330222013,530330222013,"Block Group 3, Census Tract 222.01, King County, Washington",722,92,104,66,22,24,82,65,618,108,107,53,511,116
1500000US530330222014,530330222014,"Block Group 4, Census Tract 222.01, King County, Washington",362,62,0,12,0,12,0,12,362,62,45,30,317,58
1500000US530330222021,530330222021,"Block Group 1, Census Tract 222.02, King County, Washington",500,78,55,28,25,24,30,24,445,72,27,30,418,74
1500000US530330222022,530330222022,"Block Group 2, Census Tract 222.02, King County, Washington",562,107,29,33,19,29,10,16,533,114,29,34,504,118
1500000US530330222023,530330222023,"Block Group 3, Census Tract 222.02, King County, Washington",523,98,14,24,0,12,14,24,509,99,100,70,409,93
1500000US530330222024,530330222024,"Block Group 4, Census Tract 222.02, King County, Washington",391,88,12,19,0,12,12,19,379,91,93,52,286,88
1500000US530330222025,530330222025,"Block Group 5, Census Tract 222.02, King County, Washington",1278,151,77,57,61,46,16,25,1201,165,181,87,1020,160
1500000US530330222031,530330222031,"Block Group 1, Census Tract 222.03, King County, Washington",743,84,0,12,0,12,0,12,743,84,71,44,672,87
1500000US530330222032,530330222032,"Block Group 2, Census Tract 222.03, King County, Washington",634,74,0,12,0,12,0,12,634,74,114,56,520,79
1500000US530330222033,530330222033,"Block Group 3, Census Tract 222.03, King County, Washington",496,97,22,26,12,19,10,17,474,94,110,75,364,92
1500000US530330223001,530330223001,"Block Group 1, Census Tract 223, King County, Washington",574,55,12,18,12,18,0,12,562,56,96,51,466,63
1500000US530330223002,530330223002,"Block Group 2, Census Tract 223, King County, Washington",431,60,0,12,0,12,0,12,431,60,26,29,405,56
1500000US530330224001,530330224001,"Block Group 1, Census Tract 224, King County, Washington",735,101,13,21,13,21,0,12,722,103,98,62,624,108
1500000US530330224002,530330224002,"Block Group 2, Census Tract 224, King County, Washington",513,107,0,12,0,12,0,12,513,107,38,42,475,103
1500000US530330224003,530330224003,"Block Group 3, Census Tract 224, King County, Washington",624,142,14,24,0,12,14,24,610,142,12,20,598,142
1500000US530330224004,530330224004,"Block Group 4, Census Tract 224, King County, Washington",870,137,55,52,37,41,18,29,815,134,70,53,745,141
1500000US530330224005,530330224005,"Block Group 5, Census Tract 224, King County, Washington",424,132,20,33,20,33,0,12,404,136,35,40,369,135
1500000US530330224006,530330224006,"Block Group 6, Census Tract 224, King County, Washington",551,108,43,64,0,12,43,64,508,109,19,30,489,104
1500000US530330225001,530330225001,"Block Group 1, Census Tract 225, King County, Washington",554,115,15,25,15,25,0,12,539,120,99,82,440,103
1500000US530330225002,530330225002,"Block Group 2, Census Tract 225, King County, Washington",555,103,15,23,15,23,0,12,540,104,89,72,451,101
1500000US530330225003,530330225003,"Block Group 3, Census Tract 225, King County, Washington",560,139,29,32,16,25,13,21,531,139,58,72,473,126
1500000US530330225004,530330225004,"Block Group 4, Census Tract 225, King County, Washington",947,163,19,30,0,12,19,30,928,163,227,107,701,139
1500000US530330225005,530330225005,"Block Group 5, Census Tract 225, King County, Washington",1069,140,0,12,0,12,0,12,1069,140,128,72,941,130
1500000US530330226031,530330226031,"Block Group 1, Census Tract 226.03, King County, Washington",315,105,8,14,0,12,8,14,307,108,29,45,278,101
1500000US530330226032,530330226032,"Block Group 2, Census Tract 226.03, King County, Washington",269,58,0,12,0,12,0,12,269,58,40,31,229,62
1500000US530330226033,530330226033,"Block Group 3, Census Tract 226.03, King County, Washington",324,83,0,12,0,12,0,12,324,83,67,62,257,81
1500000US530330226034,530330226034,"Block Group 4, Census Tract 226.03, King County, Washington",658,88,79,80,0,12,79,80,579,96,123,71,456,98
1500000US530330226035,530330226035,"Block Group 5, Census Tract 226.03, King County, Washington",563,117,15,25,0,12,15,25,548,124,55,41,493,127
1500000US530330226041,530330226041,"Block Group 1, Census Tract 226.04, King County, Washington",610,69,13,17,0,12,13,17,597,70,44,32,553,70
1500000US530330226042,530330226042,"Block Group 2, Census Tract 226.04, King County, Washington",600,68,47,41,40,39,7,11,553,79,166,70,387,82
1500000US530330226043,530330226043,"Block Group 3, Census Tract 226.04, King County, Washington",482,61,16,19,16,19,0,12,466,64,39,32,427,64
1500000US530330226051,530330226051,"Block Group 1, Census Tract 226.05, King County, Washington",1181,146,105,64,16,25,89,63,1076,145,212,108,864,154
1500000US530330226052,530330226052,"Block Group 2, Census Tract 226.05, King County, Washington",587,106,0,12,0,12,0,12,587,106,108,83,479,102
1500000US530330226053,530330226053,"Block Group 3, Census Tract 226.05, King County, Washington",784,150,15,24,0,12,15,24,769,151,118,110,651,151
1500000US530330226061,530330226061,"Block Group 1, Census Tract 226.06, King County, Washington",529,143,0,12,0,12,0,12,529,143,230,121,299,108
1500000US530330226062,530330226062,"Block Group 2, Census Tract 226.06, King County, Washington",702,150,122,106,86,104,36,45,580,140,58,47,522,147
1500000US530330226063,530330226063,"Block Group 3, Census Tract 226.06, King County, Washington",602,98,29,36,12,21,17,29,573,106,89,55,484,112
1500000US530330226064,530330226064,"Block Group 4, Census Tract 226.06, King County, Washington",474,102,0,12,0,12,0,12,474,102,88,48,386,116
1500000US530330227011,530330227011,"Block Group 1, Census Tract 227.01, King County, Washington",821,92,11,18,0,12,11,18,810,92,154,55,656,87
1500000US530330227012,530330227012,"Block Group 2, Census Tract 227.01, King County, Washington",627,81,8,13,0,12,8,13,619,80,37,33,582,76
1500000US530330227021,530330227021,"Block Group 1, Census Tract 227.02, King County, Washington",563,97,0,12,0,12,0,12,563,97,53,37,510,101
1500000US530330227022,530330227022,"Block Group 2, Census Tract 227.02, King County, Washington",381,82,26,28,0,12,26,28,355,82,40,30,315,81
1500000US530330227023,530330227023,"Block Group 3, Census Tract 227.02, King County, Washington",418,55,9,14,9,14,0,12,409,53,26,16,383,56
1500000US530330227031,530330227031,"Block Group 1, Census Tract 227.03, King County, Washington",531,52,13,15,0,12,13,15,518,53,64,27,454,57
1500000US530330227032,530330227032,"Block Group 2, Census Tract 227.03, King County, Washington",320,38,31,21,27,21,4,7,289,41,32,24,257,41
1500000US530330228011,530330228011,"Block Group 1, Census Tract 228.01, King County, Washington",1293,167,14,23,0,12,14,23,1279,170,67,52,1212,167
1500000US530330228012,530330228012,"Block Group 2, Census Tract 228.01, King County, Washington",1274,163,62,48,48,45,14,22,1212,163,61,47,1151,174
1500000US530330228013,530330228013,"Block Group 3, Census Tract 228.01, King County, Washington",525,94,0,12,0,12,0,12,525,94,107,69,418,100
1500000US530330228014,530330228014,"Block Group 4, Census Tract 228.01, King County, Washington",716,114,62,53,44,41,18,32,654,116,81,75,573,117
1500000US530330228021,530330228021,"Block Group 1, Census Tract 228.02, King County, Washington",844,90,7,12,7,12,0,12,837,90,17,19,820,92
1500000US530330228022,530330228022,"Block Group 2, Census Tract 228.02, King County, Washington",596,86,10,17,10,17,0,12,586,85,70,41,516,95
1500000US530330228023,530330228023,"Block Group 3, Census Tract 228.02, King County, Washington",652,85,18,29,0,12,18,29,634,85,116,63,518,94
1500000US530330228031,530330228031,"Block Group 1, Census Tract 228.03, King County, Washington",300,91,0,12,0,12,0,12,300,91,44,65,256,88
1500000US530330228032,530330228032,"Block Group 2, Census Tract 228.03, King County, Washington",1139,135,9,14,0,12,9,14,1130,138,118,98,1012,146
1500000US530330228033,530330228033,"Block Group 3, Census Tract 228.03, King County, Washington",774,131,228,90,80,80,148,90,546,118,72,52,474,120
1500000US530330229011,530330229011,"Block Group 1, Census Tract 229.01, King County, Washington",565,58,18,20,14,18,4,10,547,58,119,46,428,56
1500000US530330229012,530330229012,"Block Group 2, Census Tract 229.01, King County, Washington",418,57,9,17,9,17,0,12,409,59,69,40,340,57
1500000US530330229021,530330229021,"Block Group 1, Census Tract 229.02, King County, Washington",691,114,0,12,0,12,0,12,691,114,76,56,615,119
1500000US530330229022,530330229022,"Block Group 2, Census Tract 229.02, King County, Washington",308,56,0,12,0,12,0,12,308,56,80,59,228,72
1500000US530330229023,530330229023,"Block Group 3, Census Tract 229.02, King County, Washington",325,87,0,12,0,12,0,12,325,87,164,85,161,68
1500000US530330229024,530330229024,"Block Group 4, Census Tract 229.02, King County, Washington",722,128,8,14,0,12,8,14,714,129,83,75,631,142
1500000US530330229025,530330229025,"Block Group 5, Census Tract 229.02, King County, Washington",385,71,0,12,0,12,0,12,385,71,39,41,346,82
1500000US530330230001,530330230001,"Block Group 1, Census Tract 230, King County, Washington",473,55,21,19,16,18,5,9,452,59,141,53,311,65
1500000US530330230002,530330230002,"Block Group 2, Census Tract 230, King County, Washington",388,62,9,14,0,12,9,14,379,65,63,35,316,66
1500000US530330230003,530330230003,"Block Group 3, Census Tract 230, King County, Washington",490,73,11,17,0,12,11,17,479,75,85,53,394,77
1500000US530330230004,530330230004,"Block Group 4, Census Tract 230, King County, Washington",442,82,8,13,8,13,0,12,434,82,74,34,360,86
1500000US530330231001,530330231001,"Block Group 1, Census Tract 231, King County, Washington",410,59,39,48,39,48,0,12,371,60,60,33,311,61
1500000US530330231002,530330231002,"Block Group 2, Census Tract 231, King County, Washington",388,49,31,27,15,18,16,18,357,43,54,32,303,48
1500000US530330231003,530330231003,"Block Group 3, Census Tract 231, King County, Washington",588,84,0,12,0,12,0,12,588,84,98,40,490,86
1500000US530330232011,530330232011,"Block Group 1, Census Tract 232.01, King County, Washington",408,94,0,12,0,12,0,12,408,94,146,61,262,92
1500000US530330232012,530330232012,"Block Group 2, Census Tract 232.01, King County, Washington",832,148,145,104,145,104,0,12,687,152,58,45,629,145
1500000US530330232013,530330232013,"Block Group 3, Census Tract 232.01, King County, Washington",1275,164,52,44,52,44,0,12,1223,170,179,105,1044,161
1500000US530330232021,530330232021,"Block Group 1, Census Tract 232.02, King County, Washington",804,114,222,78,165,78,57,41,582,94,97,39,485,94
1500000US530330232022,530330232022,"Block Group 2, Census Tract 232.02, King County, Washington",435,74,25,23,19,21,6,11,410,79,37,32,373,83
1500000US530330232023,530330232023,"Block Group 3, Census Tract 232.02, King County, Washington",542,103,77,60,28,44,49,42,465,99,59,35,406,93
1500000US530330233001,530330233001,"Block Group 1, Census Tract 233, King County, Washington",613,84,10,16,0,12,10,16,603,85,116,56,487,89
1500000US530330233002,530330233002,"Block Group 2, Census Tract 233, King County, Washington",467,113,54,84,0,12,54,84,413,110,113,89,300,119
1500000US530330233003,530330233003,"Block Group 3, Census Tract 233, King County, Washington",628,121,181,137,121,105,60,95,447,87,145,59,302,88
1500000US530330233004,530330233004,"Block Group 4, Census Tract 233, King County, Washington",531,81,52,52,15,24,37,46,479,89,159,86,320,73
1500000US530330234011,530330234011,"Block Group 1, Census Tract 234.01, King County, Washington",388,85,22,31,0,12,22,31,366,83,103,59,263,73
1500000US530330234012,530330234012,"Block Group 2, Census Tract 234.01, King County, Washington",669,92,37,32,23,28,14,17,632,92,97,47,535,90
1500000US530330234013,530330234013,"Block Group 3, Census Tract 234.01, King County, Washington",414,65,49,24,0,12,49,24,365,64,48,28,317,70
1500000US530330234031,530330234031,"Block Group 1, Census Tract 234.03, King County, Washington",639,83,8,12,0,12,8,12,631,84,44,33,587,91
1500000US530330234032,530330234032,"Block Group 2, Census Tract 234.03, King County, Washington",451,87,14,21,0,12,14,21,437,85,72,40,365,86
1500000US530330234033,530330234033,"Block Group 3, Census Tract 234.03, King County, Washington",450,73,7,12,0,12,7,12,443,71,31,30,412,73
1500000US530330234041,530330234041,"Block Group 1, Census Tract 234.04, King County, Washington",648,83,27,28,5,10,22,26,621,86,52,32,569,89
1500000US530330234042,530330234042,"Block Group 2, Census Tract 234.04, King County, Washington",504,64,0,12,0,12,0,12,504,64,36,29,468,63
1500000US530330235001,530330235001,"Block Group 1, Census Tract 235, King County, Washington",465,59,0,12,0,12,0,12,465,59,108,56,357,75
1500000US530330235002,530330235002,"Block Group 2, Census Tract 235, King County, Washington",414,71,9,14,9,14,0,12,405,70,77,42,328,73
1500000US530330235003,530330235003,"Block Group 3, Census Tract 235, King County, Washington",506,69,67,50,36,34,31,39,439,68,59,42,380,63
1500000US530330236011,530330236011,"Block Group 1, Census Tract 236.01, King County, Washington",621,90,44,27,8,14,36,24,577,90,99,52,478,90
1500000US530330236012,530330236012,"Block Group 2, Census Tract 236.01, King County, Washington",675,71,68,53,19,31,49,44,607,74,63,38,544,78
1500000US530330236013,530330236013,"Block Group 3, Census Tract 236.01, King County, Washington",343,57,0,12,0,12,0,12,343,57,31,24,312,60
1500000US530330236031,530330236031,"Block Group 1, Census Tract 236.03, King County, Washington",472,108,15,19,15,19,0,12,457,114,67,39,390,122
1500000US530330236032,530330236032,"Block Group 2, Census Tract 236.03, King County, Washington",933,130,26,31,13,21,13,21,907,129,39,38,868,124
1500000US530330236033,530330236033,"Block Group 3, Census Tract 236.03, King County, Washington",457,83,61,73,61,73,0,12,396,96,72,49,324,91
1500000US530330236034,530330236034,"Block Group 4, Census Tract 236.03, King County, Washington",518,114,127,84,25,29,102,87,391,110,68,58,323,127
1500000US530330236041,530330236041,"Block Group 1, Census Tract 236.04, King County, Washington",961,143,127,108,0,12,127,108,834,131,254,137,580,134
1500000US530330236042,530330236042,"Block Group 2, Census Tract 236.04, King County, Washington",345,74,67,37,10,20,57,31,278,74,61,45,217,81
1500000US530330236043,530330236043,"Block Group 3, Census Tract 236.04, King County, Washington",768,139,0,12,0,12,0,12,768,139,227,77,541,140
1500000US530330236044,530330236044,"Block Group 4, Census Tract 236.04, King County, Washington",356,87,64,67,0,12,64,67,292,68,33,32,259,75
1500000US530330237001,530330237001,"Block Group 1, Census Tract 237, King County, Washington",268,46,8,13,0,12,8,13,260,47,35,29,225,49
1500000US530330237002,530330237002,"Block Group 2, Census Tract 237, King County, Washington",715,76,8,14,0,12,8,14,707,79,82,45,625,90
1500000US530330237003,530330237003,"Block Group 3, Census Tract 237, King County, Washington",725,74,6,11,0,12,6,11,719,72,78,50,641,75
1500000US530330238011,530330238011,"Block Group 1, Census Tract 238.01, King County, Washington",679,86,19,21,0,12,19,21,660,82,96,50,564,93
1500000US530330238012,530330238012,"Block Group 2, Census Tract 238.01, King County, Washington",477,83,41,42,32,39,9,15,436,91,62,37,374,92
1500000US530330238031,530330238031,"Block Group 1, Census Tract 238.03, King County, Washington",1239,220,0,12,0,12,0,12,1239,220,228,120,1011,200
1500000US530330238032,530330238032,"Block Group 2, Census Tract 238.03, King County, Washington",1301,178,49,45,49,45,0,12,1252,183,217,120,1035,196
1500000US530330238041,530330238041,"Block Group 1, Census Tract 238.04, King County, Washington",856,158,84,53,34,39,50,52,772,160,130,77,642,140
1500000US530330238042,530330238042,"Block Group 2, Census Tract 238.04, King County, Washington",919,211,0,12,0,12,0,12,919,211,72,75,847,217
1500000US530330238043,530330238043,"Block Group 3, Census Tract 238.04, King County, Washington",1787,309,138,136,117,133,21,32,1649,321,158,129,1491,317
1500000US530330239001,530330239001,"Block Group 1, Census Tract 239, King County, Washington",956,142,66,45,31,23,35,39,890,153,143,73,747,143
1500000US530330239002,530330239002,"Block Group 2, Census Tract 239, King County, Washington",632,95,0,12,0,12,0,12,632,95,79,54,553,109
1500000US530330239003,530330239003,"Block Group 3, Census Tract 239, King County, Washington",679,120,1,3,0,12,1,3,678,119,69,57,609,115
1500000US530330239004,530330239004,"Block Group 4, Census Tract 239, King County, Washington",560,109,0,12,0,12,0,12,560,109,91,51,469,120
1500000US530330240001,530330240001,"Block Group 1, Census Tract 240, King County, Washington",691,135,33,39,18,29,15,26,658,140,29,34,629,141
1500000US530330240002,530330240002,"Block Group 2, Census Tract 240, King County, Washington",754,144,0,12,0,12,0,12,754,144,103,72,651,151
1500000US530330240003,530330240003,"Block Group 3, Census Tract 240, King County, Washington",938,142,47,75,0,12,47,75,891,139,129,72,762,149
1500000US530330240004,530330240004,"Block Group 4, Census Tract 240, King County, Washington",937,138,31,35,17,26,14,22,906,139,139,93,767,147
1500000US530330241001,530330241001,"Block Group 1, Census Tract 241, King County, Washington",360,39,0,12,0,12,0,12,360,39,47,16,313,42
1500000US530330241002,530330241002,"Block Group 2, Census Tract 241, King County, Washington",346,38,6,6,3,4,3,4,340,38,59,22,281,33
1500000US530330241003,530330241003,"Block Group 3, Census Tract 241, King County, Washington",507,40,0,12,0,12,0,12,507,40,88,26,419,42
1500000US530330241004,530330241004,"Block Group 4, Census Tract 241, King County, Washington",373,44,4,5,0,12,4,5,369,45,73,37,296,50
1500000US530330242001,530330242001,"Block Group 1, Census Tract 242, King County, Washington",460,55,0,12,0,12,0,12,460,55,63,33,397,55
1500000US530330242002,530330242002,"Block Group 2, Census Tract 242, King County, Washington",594,50,5,8,5,8,0,12,589,50,82,32,507,56
1500000US530330243001,530330243001,"Block Group 1, Census Tract 243, King County, Washington",500,85,0,12,0,12,0,12,500,85,14,23,486,84
1500000US530330243002,530330243002,"Block Group 2, Census Tract 243, King County, Washington",1241,159,35,39,19,29,16,25,1206,157,263,106,943,159
1500000US530330243003,530330243003,"Block Group 3, Census Tract 243, King County, Washington",434,90,13,22,0,12,13,22,421,94,59,48,362,100
1500000US530330243004,530330243004,"Block Group 4, Census Tract 243, King County, Washington",902,128,82,61,68,61,14,22,820,141,207,99,613,140
1500000US530330243005,530330243005,"Block Group 5, Census Tract 243, King County, Washington",435,78,15,25,0,12,15,25,420,81,13,22,407,83
1500000US530330244001,530330244001,"Block Group 1, Census Tract 244, King County, Washington",512,62,9,14,0,12,9,14,503,61,177,64,326,75
1500000US530330244002,530330244002,"Block Group 2, Census Tract 244, King County, Washington",801,87,48,62,0,12,48,62,753,92,80,64,673,98
1500000US530330245001,530330245001,"Block Group 1, Census Tract 245, King County, Washington",727,70,0,12,0,12,0,12,727,70,94,45,633,80
1500000US530330245002,530330245002,"Block Group 2, Census Tract 245, King County, Washington",509,61,8,12,8,12,0,12,501,63,79,39,422,69
1500000US530330245003,530330245003,"Block Group 3, Census Tract 245, King County, Washington",459,70,8,12,8,12,0,12,451,72,83,50,368,74
1500000US530330246011,530330246011,"Block Group 1, Census Tract 246.01, King County, Washington",562,68,15,18,15,18,0,12,547,70,165,61,382,71
1500000US530330246012,530330246012,"Block Group 2, Census Tract 246.01, King County, Washington",504,67,0,12,0,12,0,12,504,67,151,55,353,78
1500000US530330246013,530330246013,"Block Group 3, Census Tract 246.01, King County, Washington",571,71,0,12,0,12,0,12,571,71,46,30,525,79
1500000US530330246021,530330246021,"Block Group 1, Census Tract 246.02, King County, Washington",331,50,0,12,0,12,0,12,331,50,27,20,304,53
1500000US530330246022,530330246022,"Block Group 2, Census Tract 246.02, King County, Washington",691,69,0,12,0,12,0,12,691,69,105,40,586,74
1500000US530330246023,530330246023,"Block Group 3, Census Tract 246.02, King County, Washington",252,46,0,12,0,12,0,12,252,46,33,27,219,54
1500000US530330247011,530330247011,"Block Group 1, Census Tract 247.01, King County, Washington",490,86,31,29,13,20,18,21,459,88,71,54,388,86
1500000US530330247012,530330247012,"Block Group 2, Census Tract 247.01, King County, Washington",597,80,92,66,10,16,82,64,505,77,87,51,418,77
1500000US530330247013,530330247013,"Block Group 3, Census Tract 247.01, King County, Washington",335,82,17,20,8,13,9,15,318,82,61,40,257,87
1500000US530330247021,530330247021,"Block Group 1, Census Tract 247.02, King County, Washington",774,138,0,12,0,12,0,12,774,138,85,53,689,139
1500000US530330247022,530330247022,"Block Group 2, Census Tract 247.02, King County, Washington",443,95,58,83,0,12,58,83,385,73,64,54,321,75
1500000US530330247023,530330247023,"Block Group 3, Census Tract 247.02, King County, Washington",614,108,0,12,0,12,0,12,614,108,48,48,566,110
1500000US530330247024,530330247024,"Block Group 4, Census Tract 247.02, King County, Washington",522,78,0,12,0,12,0,12,522,78,63,52,459,93
1500000US530330247025,530330247025,"Block Group 5, Census Tract 247.02, King County, Washington",527,138,0,12,0,12,0,12,527,138,85,55,442,129
1500000US530330248001,530330248001,"Block Group 1, Census Tract 248, King County, Washington",363,86,32,28,32,28,0,12,331,95,28,30,303,102
1500000US530330248002,530330248002,"Block Group 2, Census Tract 248, King County, Washington",717,113,12,19,12,19,0,12,705,112,179,85,526,118
1500000US530330248003,530330248003,"Block Group 3, Census Tract 248, King County, Washington",1057,160,122,110,19,22,103,107,935,147,62,58,873,155
1500000US530330249011,530330249011,"Block Group 1, Census Tract 249.01, King County, Washington",383,59,31,27,10,16,21,22,352,66,103,60,249,62
1500000US530330249012,530330249012,"Block Group 2, Census Tract 249.01, King County, Washington",567,64,0,12,0,12,0,12,567,64,119,43,448,76
1500000US530330249013,530330249013,"Block Group 3, Census Tract 249.01, King County, Washington",416,47,6,10,6,10,0,12,410,50,19,21,391,54
1500000US530330249014,530330249014,"Block Group 4, Census Tract 249.01, King County, Washington",370,58,0,12,0,12,0,12,370,58,59,36,311,52
1500000US530330249021,530330249021,"Block Group 1, Census Tract 249.02, King County, Washington",403,57,0,12,0,12,0,12,403,57,42,27,361,61
1500000US530330249022,530330249022,"Block Group 2, Census Tract 249.02, King County, Washington",501,78,10,13,10,13,0,12,491,79,49,28,442,78
1500000US530330249023,530330249023,"Block Group 3, Census Tract 249.02, King County, Washington",437,66,37,32,37,32,0,12,400,66,44,34,356,70
1500000US530330249031,530330249031,"Block Group 1, Census Tract 249.03, King County, Washington",660,83,16,24,16,24,0,12,644,86,16,26,628,90
1500000US530330249032,530330249032,"Block Group 2, Census Tract 249.03, King County, Washington",595,77,0,12,0,12,0,12,595,77,91,61,504,87
1500000US530330249033,530330249033,"Block Group 3, Census Tract 249.03, King County, Washington",417,52,0,12,0,12,0,12,417,52,35,34,382,62
1500000US530330249034,530330249034,"Block Group 4, Census Tract 249.03, King County, Washington",544,75,14,21,0,12,14,21,530,78,67,51,463,95
1500000US530330250011,530330250011,"Block Group 1, Census Tract 250.01, King County, Washington",301,58,0,12,0,12,0,12,301,58,27,23,274,57
1500000US530330250012,530330250012,"Block Group 2, Census Tract 250.01, King County, Washington",641,93,36,46,0,12,36,46,605,91,59,47,546,91
1500000US530330250013,530330250013,"Block Group 3, Census Tract 250.01, King County, Washington",477,58,27,24,0,12,27,24,450,64,82,47,368,66
1500000US530330250014,530330250014,"Block Group 4, Census Tract 250.01, King County, Washington",339,66,30,26,0,12,30,26,309,70,34,20,275,69
1500000US530330250031,530330250031,"Block Group 1, Census Tract 250.03, King County, Washington",452,96,0,12,0,12,0,12,452,96,36,37,416,101
1500000US530330250032,530330250032,"Block Group 2, Census Tract 250.03, King County, Washington",429,78,54,68,0,12,54,68,375,72,14,23,361,76
1500000US530330250033,530330250033,"Block Group 3, Census Tract 250.03, King County, Washington",627,94,24,29,13,22,11,19,603,91,74,64,529,90
1500000US530330250034,530330250034,"Block Group 4, Census Tract 250.03, King County, Washington",462,108,18,28,0,12,18,28,444,115,44,40,400,118
1500000US530330250035,530330250035,"Block Group 5, Census Tract 250.03, King County, Washington",614,134,0,12,0,12,0,12,614,134,112,74,502,145
1500000US530330250051,530330250051,"Block Group 1, Census Tract 250.05, King County, Washington",1008,105,22,28,0,12,22,28,986,112,62,42,924,111
1500000US530330250052,530330250052,"Block Group 2, Census Tract 250.05, King County, Washington",893,125,93,68,65,60,28,34,800,129,169,84,631,116
1500000US530330250061,530330250061,"Block Group 1, Census Tract 250.06, King County, Washington",462,112,24,39,0,12,24,39,438,123,11,18,427,125
1500000US530330250062,530330250062,"Block Group 2, Census Tract 250.06, King County, Washington",1165,152,56,85,56,85,0,12,1109,152,231,99,878,157
1500000US530330250063,530330250063,"Block Group 3, Census Tract 250.06, King County, Washington",462,104,0,12,0,12,0,12,462,104,31,30,431,106
1500000US530330251011,530330251011,"Block Group 1, Census Tract 251.01, King County, Washington",531,114,224,98,75,69,149,100,307,111,35,29,272,112
1500000US530330251012,530330251012,"Block Group 2, Census Tract 251.01, King County, Washington",527,138,162,92,88,77,74,66,365,121,71,53,294,123
1500000US530330251013,530330251013,"Block Group 3, Census Tract 251.01, King County, Washington",315,75,0,12,0,12,0,12,315,75,28,30,287,75
1500000US530330251014,530330251014,"Block Group 4, Census Tract 251.01, King County, Washington",668,100,31,35,15,25,16,26,637,105,39,35,598,106
1500000US530330251021,530330251021,"Block Group 1, Census Tract 251.02, King County, Washington",452,105,32,40,0,12,32,40,420,106,16,26,404,106
1500000US530330251022,530330251022,"Block Group 2, Census Tract 251.02, King County, Washington",506,123,44,59,0,12,44,59,462,120,105,73,357,107
1500000US530330251023,530330251023,"Block Group 3, Census Tract 251.02, King County, Washington",1146,143,58,45,13,21,45,45,1088,143,204,101,884,152
1500000US530330251024,530330251024,"Block Group 4, Census Tract 251.02, King County, Washington",559,144,0,12,0,12,0,12,559,144,119,95,440,102
1500000US530330252001,530330252001,"Block Group 1, Census Tract 252, King County, Washington",464,112,21,33,21,33,0,12,443,111,61,47,382,111
1500000US530330252002,530330252002,"Block Group 2, Census Tract 252, King County, Washington",932,149,87,82,73,75,14,24,845,149,189,79,656,150
1500000US530330252003,530330252003,"Block Group 3, Census Tract 252, King County, Washington",525,118,123,79,38,47,85,75,402,109,84,46,318,113
1500000US530330252004,530330252004,"Block Group 4, Census Tract 252, King County, Washington",735,107,123,58,81,49,42,42,612,98,146,57,466,106
1500000US530330252005,530330252005,"Block Group 5, Census Tract 252, King County, Washington",455,83,54,49,11,17,43,45,401,90,13,21,388,93
1500000US530330253011,530330253011,"Block Group 1, Census Tract 253.01, King County, Washington",689,157,9,14,0,12,9,14,680,156,62,44,618,163
1500000US530330253012,530330253012,"Block Group 2, Census Tract 253.01, King County, Washington",763,154,27,33,0,12,27,33,736,152,24,30,712,153
1500000US530330253013,530330253013,"Block Group 3, Census Tract 253.01, King County, Washington",1033,180,92,59,11,18,81,56,941,183,80,57,861,186
1500000US530330253021,530330253021,"Block Group 1, Census Tract 253.02, King County, Washington",1165,188,171,103,140,98,31,31,994,175,248,110,746,175
1500000US530330253022,530330253022,"Block Group 2, Census Tract 253.02, King County, Washington",708,143,42,57,0,12,42,57,666,132,156,78,510,126
1500000US530330253023,530330253023,"Block Group 3, Census Tract 253.02, King County, Washington",630,155,194,79,100,70,94,48,436,153,85,83,351,140
1500000US530330254001,530330254001,"Block Group 1, Census Tract 254, King County, Washington",521,141,103,87,51,54,52,67,418,133,106,53,312,135
1500000US530330254002,530330254002,"Block Group 2, Census Tract 254, King County, Washington",886,164,283,120,71,48,212,120,603,163,95,86,508,146
1500000US530330254003,530330254003,"Block Group 3, Census Tract 254, King County, Washington",1084,182,230,123,57,46,173,115,854,175,163,66,691,170
1500000US530330254004,530330254004,"Block Group 4, Census Tract 254, King County, Washington",454,121,43,44,0,12,43,44,411,122,38,29,373,122
1500000US530330255001,530330255001,"Block Group 1, Census Tract 255, King County, Washington",931,93,149,87,64,47,85,69,782,91,84,58,698,102
1500000US530330255002,530330255002,"Block Group 2, Census Tract 255, King County, Washington",516,86,37,25,0,12,37,25,479,88,140,57,339,84
1500000US530330255003,530330255003,"Block Group 3, Census Tract 255, King County, Washington",478,82,70,55,57,56,13,20,408,77,96,44,312,86
1500000US530330256011,530330256011,"Block Group 1, Census Tract 256.01, King County, Washington",410,81,22,25,0,12,22,25,388,86,51,46,337,86
1500000US530330256012,530330256012,"Block Group 2, Census Tract 256.01, King County, Washington",971,109,103,85,62,67,41,53,868,118,150,74,718,134
1500000US530330256013,530330256013,"Block Group 3, Census Tract 256.01, King County, Washington",521,99,66,48,8,13,58,46,455,97,58,47,397,85
1500000US530330256021,530330256021,"Block Group 1, Census Tract 256.02, King County, Washington",834,94,98,62,12,19,86,59,736,109,144,68,592,107
1500000US530330256022,530330256022,"Block Group 2, Census Tract 256.02, King County, Washington",338,81,24,28,10,15,14,23,314,82,83,54,231,77
1500000US530330256023,530330256023,"Block Group 3, Census Tract 256.02, King County, Washington",847,86,57,42,15,21,42,33,790,90,109,53,681,108
1500000US530330257011,530330257011,"Block Group 1, Census Tract 257.01, King County, Washington",405,104,55,48,13,23,42,41,350,102,33,30,317,103
1500000US530330257012,530330257012,"Block Group 2, Census Tract 257.01, King County, Washington",476,107,94,84,82,83,12,21,382,107,78,55,304,93
1500000US530330257013,530330257013,"Block Group 3, Census Tract 257.01, King County, Washington",446,125,225,97,139,92,86,73,221,117,40,45,181,111
1500000US530330257014,530330257014,"Block Group 4, Census Tract 257.01, King County, Washington",531,161,41,50,0,12,41,50,490,155,47,45,443,161
1500000US530330257015,530330257015,"Block Group 5, Census Tract 257.01, King County, Washington",684,190,79,65,13,20,66,65,605,182,126,71,479,170
1500000US530330257021,530330257021,"Block Group 1, Census Tract 257.02, King County, Washington",460,82,17,27,0,12,17,27,443,81,106,72,337,87
1500000US530330257022,530330257022,"Block Group 2, Census Tract 257.02, King County, Washington",384,73,0,12,0,12,0,12,384,73,48,31,336,76
1500000US530330257023,530330257023,"Block Group 3, Census Tract 257.02, King County, Washington",398,54,70,40,51,37,19,24,328,67,90,48,238,78
1500000US530330258031,530330258031,"Block Group 1, Census Tract 258.03, King County, Washington",453,74,48,39,0,12,48,39,405,73,87,52,318,68
1500000US530330258032,530330258032,"Block Group 2, Census Tract 258.03, King County, Washington",609,100,58,38,19,19,39,32,551,105,188,84,363,90
1500000US530330258033,530330258033,"Block Group 3, Census Tract 258.03, King County, Washington",635,90,248,98,137,70,111,75,387,98,41,46,346,98
1500000US530330258041,530330258041,"Block Group 1, Census Tract 258.04, King County, Washington",458,62,36,32,26,28,10,16,422,60,92,39,330,64
1500000US530330258042,530330258042,"Block Group 2, Census Tract 258.04, King County, Washington",352,55,25,24,22,20,3,12,327,60,65,33,262,58
1500000US530330258043,530330258043,"Block Group 3, Census Tract 258.04, King County, Washington",409,72,54,45,34,33,20,31,355,76,49,31,306,80
1500000US530330258051,530330258051,"Block Group 1, Census Tract 258.05, King County, Washington",822,128,198,103,71,79,127,82,624,128,109,53,515,118
1500000US530330258052,530330258052,"Block Group 2, Census Tract 258.05, King County, Washington",343,82,10,16,10,16,0,12,333,84,53,35,280,88
1500000US530330258053,530330258053,"Block Group 3, Census Tract 258.05, King County, Washington",640,118,77,51,56,44,21,24,563,113,128,94,435,115
1500000US530330258061,530330258061,"Block Group 1, Census Tract 258.06, King County, Washington",466,73,0,12,0,12,0,12,466,73,99,53,367,74
1500000US530330258062,530330258062,"Block Group 2, Census Tract 258.06, King County, Washington",712,111,30,31,11,14,19,28,682,112,41,29,641,112
1500000US530330258063,530330258063,"Block Group 3, Census Tract 258.06, King County, Washington",501,99,165,73,49,53,116,65,336,92,36,27,300,89
1500000US530330260011,530330260011,"Block Group 1, Census Tract 260.01, King County, Washington",537,125,45,36,0,12,45,36,492,128,75,49,417,123
1500000US530330260012,530330260012,"Block Group 2, Census Tract 260.01, King County, Washington",269,70,30,32,16,17,14,25,239,74,82,55,157,60
1500000US530330260013,530330260013,"Block Group 3, Census Tract 260.01, King County, Washington",515,105,35,37,9,15,26,36,480,111,107,56,373,130
1500000US530330260014,530330260014,"Block Group 4, Census Tract 260.01, King County, Washington",356,102,88,72,41,39,47,60,268,77,69,41,199,71
1500000US530330260015,530330260015,"Block Group 5, Census Tract 260.01, King County, Washington",319,91,91,74,49,57,42,41,228,76,72,44,156,61
1500000US530330260021,530330260021,"Block Group 1, Census Tract 260.02, King County, Washington",1156,199,432,190,86,62,346,178,724,163,61,74,663,164
1500000US530330260022,530330260022,"Block Group 2, Census Tract 260.02, King County, Washington",709,148,112,79,21,36,91,72,597,160,222,102,375,137
1500000US530330260023,530330260023,"Block Group 3, Census Tract 260.02, King County, Washington",557,142,71,87,15,20,56,85,486,121,82,48,404,124
1500000US530330260024,530330260024,"Block Group 4, Census Tract 260.02, King County, Washington",653,137,63,60,36,39,27,44,590,139,123,93,467,128
1500000US530330261001,530330261001,"Block Group 1, Census Tract 261, King County, Washington",387,100,52,57,50,53,2,20,335,94,148,81,187,74
1500000US530330261002,530330261002,"Block Group 2, Census Tract 261, King County, Washington",451,152,42,54,0,12,42,54,409,145,119,94,290,134
1500000US530330261003,530330261003,"Block Group 3, Census Tract 261, King County, Washington",496,126,109,84,97,84,12,19,387,104,68,71,319,102
1500000US530330261004,530330261004,"Block Group 4, Census Tract 261, King County, Washington",492,144,159,113,30,39,129,106,333,125,29,34,304,122
1500000US530330261005,530330261005,"Block Group 5, Census Tract 261, King County, Washington",671,180,155,102,62,53,93,91,516,172,84,82,432,163
1500000US530330262001,530330262001,"Block Group 1, Census Tract 262, King County, Washington",51,51,31,47,31,47,0,12,20,24,0,12,20,24
1500000US530330262002,530330262002,"Block Group 2, Census Tract 262, King County, Washington",607,130,76,65,12,20,64,61,531,129,119,94,412,123
1500000US530330262003,530330262003,"Block Group 3, Census Tract 262, King County, Washington",954,155,322,124,76,81,246,116,632,144,74,62,558,151
1500000US530330262004,530330262004,"Block Group 4, Census Tract 262, King County, Washington",742,165,100,49,26,43,74,45,642,165,155,147,487,158
1500000US530330263001,530330263001,"Block Group 1, Census Tract 263, King County, Washington",152,56,7,12,0,12,7,12,145,59,39,31,106,47
1500000US530330263002,530330263002,"Block Group 2, Census Tract 263, King County, Washington",409,54,100,70,64,59,36,42,309,55,77,47,232,61
1500000US530330264001,530330264001,"Block Group 1, Census Tract 264, King County, Washington",217,99,5,14,5,14,0,12,212,101,17,27,195,110
1500000US530330264002,530330264002,"Block Group 2, Census Tract 264, King County, Washington",590,119,299,109,59,79,240,103,291,96,74,81,217,75
1500000US530330264003,530330264003,"Block Group 3, Census Tract 264, King County, Washington",444,114,59,48,23,35,36,36,385,108,81,48,304,110
1500000US530330264004,530330264004,"Block Group 4, Census Tract 264, King County, Washington",524,125,0,12,0,12,0,12,524,125,72,53,452,128
1500000US530330264005,530330264005,"Block Group 5, Census Tract 264, King County, Washington",564,137,252,125,121,104,131,100,312,126,89,72,223,139
1500000US530330265001,530330265001,"Block Group 1, Census Tract 265, King County, Washington",218,63,131,62,57,46,74,52,87,48,17,25,70,42
1500000US530330265002,530330265002,"Block Group 2, Census Tract 265, King County, Washington",608,99,409,87,154,85,255,89,199,83,43,46,156,69
1500000US530330265003,530330265003,"Block Group 3, Census Tract 265, King County, Washington",643,103,165,80,64,57,101,53,478,110,67,40,411,106
1500000US530330266001,530330266001,"Block Group 1, Census Tract 266, King County, Washington",460,70,165,61,30,20,135,60,295,61,42,24,253,59
1500000US530330266002,530330266002,"Block Group 2, Census Tract 266, King County, Washington",395,65,63,41,31,24,32,35,332,61,57,34,275,61
1500000US530330267001,530330267001,"Block Group 1, Census Tract 267, King County, Washington",448,113,31,38,16,28,15,26,417,113,56,50,361,112
1500000US530330267002,530330267002,"Block Group 2, Census Tract 267, King County, Washington",771,134,207,132,30,35,177,136,564,143,90,88,474,137
1500000US530330267003,530330267003,"Block Group 3, Census Tract 267, King County, Washington",454,79,14,24,0,12,14,24,440,83,110,74,330,73
1500000US530330267004,530330267004,"Block Group 4, Census Tract 267, King County, Washington",357,68,0,12,0,12,0,12,357,68,70,46,287,65
1500000US530330268011,530330268011,"Block Group 1, Census Tract 268.01, King County, Washington",398,79,45,45,35,42,10,16,353,90,208,82,145,63
1500000US530330268012,530330268012,"Block Group 2, Census Tract 268.01, King County, Washington",607,123,196,91,111,70,85,69,411,103,64,35,347,104
1500000US530330268013,530330268013,"Block Group 3, Census Tract 268.01, King County, Washington",577,134,269,102,93,63,176,98,308,136,7,12,301,137
1500000US530330268014,530330268014,"Block Group 4, Census Tract 268.01, King County, Washington",506,117,206,111,138,92,68,56,300,114,59,54,241,109
1500000US530330268021,530330268021,"Block Group 1, Census Tract 268.02, King County, Washington",258,71,68,38,37,31,31,29,190,78,58,45,132,65
1500000US530330268022,530330268022,"Block Group 2, Census Tract 268.02, King County, Washington",265,72,78,58,27,33,51,50,187,61,24,22,163,60
1500000US530330268023,530330268023,"Block Group 3, Census Tract 268.02, King County, Washington",485,99,140,76,86,55,54,51,345,83,96,59,249,82
1500000US530330268024,530330268024,"Block Group 4, Census Tract 268.02, King County, Washington",514,85,132,83,0,12,132,83,382,92,80,39,302,92
1500000US530330270001,530330270001,"Block Group 1, Census Tract 270, King County, Washington",281,63,60,38,56,38,4,8,221,65,59,38,162,58
1500000US530330270002,530330270002,"Block Group 2, Census Tract 270, King County, Washington",372,69,48,33,26,29,22,28,324,80,73,54,251,74
1500000US530330270003,530330270003,"Block Group 3, Census Tract 270, King County, Washington",446,58,43,39,0,12,43,39,403,66,90,49,313,68
1500000US530330271001,530330271001,"Block Group 1, Census Tract 271, King County, Washington",541,105,182,95,144,91,38,31,359,82,159,79,200,61
1500000US530330271002,530330271002,"Block Group 2, Census Tract 271, King County, Washington",670,106,166,86,51,44,115,72,504,116,75,56,429,107
1500000US530330272001,530330272001,"Block Group 1, Census Tract 272, King County, Washington",363,67,73,46,21,23,52,36,290,65,26,16,264,64
1500000US530330272002,530330272002,"Block Group 2, Census Tract 272, King County, Washington",534,81,206,64,88,43,118,58,328,86,87,39,241,82
1500000US530330273001,530330273001,"Block Group 1, Census Tract 273, King County, Washington",400,80,27,24,19,20,8,14,373,82,56,37,317,78
1500000US530330273002,530330273002,"Block Group 2, Census Tract 273, King County, Washington",764,98,467,102,217,80,250,84,297,94,51,35,246,95
1500000US530330273003,530330273003,"Block Group 3, Census Tract 273, King County, Washington",352,60,58,51,14,21,44,46,294,62,56,34,238,64
1500000US530330273004,530330273004,"Block Group 4, Census Tract 273, King County, Washington",433,95,104,59,85,57,19,19,329,88,106,51,223,73
1500000US530330274001,530330274001,"Block Group 1, Census Tract 274, King County, Washington",568,89,132,77,106,75,26,22,436,69,131,47,305,75
1500000US530330274002,530330274002,"Block Group 2, Census Tract 274, King County, Washington",376,100,81,63,5,8,76,63,295,89,49,31,246,89
1500000US530330274003,530330274003,"Block Group 3, Census Tract 274, King County, Washington",481,88,87,41,66,37,21,21,394,91,141,64,253,83
1500000US530330274004,530330274004,"Block Group 4, Census Tract 274, King County, Washington",284,91,44,33,6,10,38,35,240,87,37,28,203,86
1500000US530330275001,530330275001,"Block Group 1, Census Tract 275, King County, Washington",561,90,157,74,81,61,76,53,404,82,124,62,280,77
1500000US530330275002,530330275002,"Block Group 2, Census Tract 275, King County, Washington",408,74,48,52,33,47,15,19,360,78,107,52,253,67
1500000US530330275003,530330275003,"Block Group 3, Census Tract 275, King County, Washington",416,88,65,65,65,65,0,12,351,85,82,59,269,81
1500000US530330275004,530330275004,"Block Group 4, Census Tract 275, King County, Washington",331,54,13,20,0,12,13,20,318,57,46,28,272,64
1500000US530330276001,530330276001,"Block Group 1, Census Tract 276, King County, Washington",395,80,86,59,21,31,65,49,309,83,75,62,234,66
1500000US530330276002,530330276002,"Block Group 2, Census Tract 276, King County, Washington",901,107,337,105,136,71,201,99,564,128,120,59,444,112
1500000US530330276003,530330276003,"Block Group 3, Census Tract 276, King County, Washington",385,66,0,12,0,12,0,12,385,66,55,36,330,68
1500000US530330277011,530330277011,"Block Group 1, Census Tract 277.01, King County, Washington",564,133,30,34,30,34,0,12,534,138,180,111,354,115
1500000US530330277012,530330277012,"Block Group 2, Census Tract 277.01, King County, Washington",381,104,0,12,0,12,0,12,381,104,8,14,373,106
1500000US530330277013,530330277013,"Block Group 3, Census Tract 277.01, King County, Washington",561,157,17,27,17,27,0,12,544,165,89,103,455,157
1500000US530330277014,530330277014,"Block Group 4, Census Tract 277.01, King County, Washington",574,145,0,12,0,12,0,12,574,145,137,117,437,123
1500000US530330277015,530330277015,"Block Group 5, Census Tract 277.01, King County, Washington",517,122,14,23,0,12,14,23,503,123,69,41,434,127
1500000US530330277021,530330277021,"Block Group 1, Census Tract 277.02, King County, Washington",415,125,0,12,0,12,0,12,415,125,81,61,334,115
1500000US530330277022,530330277022,"Block Group 2, Census Tract 277.02, King County, Washington",576,126,13,20,13,20,0,12,563,126,125,82,438,104
1500000US530330277023,530330277023,"Block Group 3, Census Tract 277.02, King County, Washington",561,143,22,34,0,12,22,34,539,143,93,72,446,137
1500000US530330277024,530330277024,"Block Group 4, Census Tract 277.02, King County, Washington",555,112,0,12,0,12,0,12,555,112,171,80,384,99
1500000US530330278001,530330278001,"Block Group 1, Census Tract 278, King County, Washington",411,68,53,49,25,23,28,44,358,63,89,40,269,72
1500000US530330278002,530330278002,"Block Group 2, Census Tract 278, King County, Washington",452,59,16,18,16,18,0,12,436,58,85,45,351,65
1500000US530330278003,530330278003,"Block Group 3, Census Tract 278, King County, Washington",471,52,9,14,9,14,0,12,462,52,119,53,343,52
1500000US530330279001,530330279001,"Block Group 1, Census Tract 279, King County, Washington",588,137,143,78,84,60,59,57,445,150,122,103,323,123
1500000US530330279002,530330279002,"Block Group 2, Census Tract 279, King County, Washington",667,161,167,86,48,47,119,76,500,173,89,53,411,168
1500000US530330279003,530330279003,"Block Group 3, Census Tract 279, King County, Washington",664,143,186,134,65,53,121,120,478,132,71,61,407,130
1500000US530330279004,530330279004,"Block Group 4, Census Tract 279, King County, Washington",352,106,15,24,0,12,15,24,337,104,70,47,267,104
1500000US530330279005,530330279005,"Block Group 5, Census Tract 279, King County, Washington",298,83,76,76,56,73,20,32,222,61,109,69,113,46
1500000US530330279006,530330279006,"Block Group 6, Census Tract 279, King County, Washington",600,106,64,69,56,67,8,16,536,107,93,51,443,109
1500000US530330280001,530330280001,"Block Group 1, Census Tract 280, King County, Washington",480,106,39,33,8,10,31,31,441,108,45,32,396,115
1500000US530330280002,530330280002,"Block Group 2, Census Tract 280, King County, Washington",456,93,105,71,37,37,68,61,351,86,32,27,319,86
1500000US530330280003,530330280003,"Block Group 3, Census Tract 280, King County, Washington",434,88,117,45,98,42,19,23,317,92,63,50,254,80
1500000US530330281001,530330281001,"Block Group 1, Census Tract 281, King County, Washington",391,67,153,56,53,33,100,53,238,69,52,27,186,69
1500000US530330281002,530330281002,"Block Group 2, Census Tract 281, King County, Washington",422,74,100,65,82,69,18,19,322,82,74,42,248,72
1500000US530330282001,530330282001,"Block Group 1, Census Tract 282, King County, Washington",704,147,177,89,80,65,97,68,527,131,122,88,405,112
1500000US530330282002,530330282002,"Block Group 2, Census Tract 282, King County, Washington",539,101,58,49,51,48,7,11,481,104,80,49,401,103
1500000US530330282003,530330282003,"Block Group 3, Census Tract 282, King County, Washington",598,125,209,91,63,48,146,89,389,119,41,52,348,101
1500000US530330283001,530330283001,"Block Group 1, Census Tract 283, King County, Washington",467,81,70,67,14,16,56,65,397,64,71,35,326,67
1500000US530330283002,530330283002,"Block Group 2, Census Tract 283, King County, Washington",526,95,69,53,44,45,25,34,457,98,91,59,366,114
1500000US530330283003,530330283003,"Block Group 3, Census Tract 283, King County, Washington",938,129,61,60,13,21,48,57,877,132,89,38,788,136
1500000US530330284021,530330284021,"Block Group 1, Census Tract 284.02, King County, Washington",354,83,138,78,90,60,48,42,216,72,57,45,159,58
1500000US530330284022,530330284022,"Block Group 2, Census Tract 284.02, King County, Washington",350,99,71,54,13,16,58,51,279,89,82,45,197,83
1500000US530330284023,530330284023,"Block Group 3, Census Tract 284.02, King County, Washington",527,92,109,76,11,22,98,69,418,80,50,35,368,87
1500000US530330284024,530330284024,"Block Group 4, Census Tract 284.02, King County, Washington",473,128,106,64,0,12,106,64,367,124,68,57,299,114
1500000US530330284031,530330284031,"Block Group 1, Census Tract 284.03, King County, Washington",1295,163,353,155,37,45,316,156,942,184,156,124,786,190
1500000US530330284032,530330284032,"Block Group 2, Census Tract 284.03, King County, Washington",635,149,137,78,60,50,77,55,498,140,206,100,292,117
1500000US530330284033,530330284033,"Block Group 3, Census Tract 284.03, King County, Washington",457,97,45,44,12,19,33,47,412,92,93,62,319,99
1500000US530330285001,530330285001,"Block Group 1, Census Tract 285, King County, Washington",392,86,27,27,4,8,23,26,365,83,32,31,333,85
1500000US530330285002,530330285002,"Block Group 2, Census Tract 285, King County, Washington",526,96,76,30,76,30,0,12,450,98,99,62,351,85
1500000US530330285003,530330285003,"Block Group 3, Census Tract 285, King County, Washington",693,108,184,96,81,61,103,76,509,101,93,56,416,107
1500000US530330286001,530330286001,"Block Group 1, Census Tract 286, King County, Washington",264,69,0,12,0,12,0,12,264,69,93,51,171,64
1500000US530330286002,530330286002,"Block Group 2, Census Tract 286, King County, Washington",359,97,0,12,0,12,0,12,359,97,156,84,203,71
1500000US530330286003,530330286003,"Block Group 3, Census Tract 286, King County, Washington",493,99,23,32,0,12,23,32,470,92,160,64,310,99
1500000US530330286004,530330286004,"Block Group 4, Census Tract 286, King County, Washington",512,110,70,64,0,12,70,64,442,105,64,59,378,102
1500000US530330286005,530330286005,"Block Group 5, Census Tract 286, King County, Washington",469,107,44,66,44,66,0,12,425,94,141,51,284,85
1500000US530330286006,530330286006,"Block Group 6, Census Tract 286, King County, Washington",431,70,78,70,0,12,78,70,353,78,117,59,236,71
1500000US530330287001,530330287001,"Block Group 1, Census Tract 287, King County, Washington",367,95,47,51,47,51,0,12,320,86,101,48,219,84
1500000US530330287002,530330287002,"Block Group 2, Census Tract 287, King County, Washington",422,74,0,12,0,12,0,12,422,74,69,41,353,77
1500000US530330287003,530330287003,"Block Group 3, Census Tract 287, King County, Washington",596,100,37,29,21,21,16,18,559,101,101,66,458,101
1500000US530330287004,530330287004,"Block Group 4, Census Tract 287, King County, Washington",509,93,6,9,6,9,0,12,503,95,125,71,378,98
1500000US530330288011,530330288011,"Block Group 1, Census Tract 288.01, King County, Washington",489,70,54,37,16,23,38,29,435,72,161,56,274,73
1500000US530330288012,530330288012,"Block Group 2, Census Tract 288.01, King County, Washington",322,46,43,33,6,11,37,29,279,52,45,29,234,60
1500000US530330288013,530330288013,"Block Group 3, Census Tract 288.01, King County, Washington",25,15,8,12,8,12,0,12,17,14,2,9,15,11
1500000US530330288021,530330288021,"Block Group 1, Census Tract 288.02, King County, Washington",865,170,261,124,143,100,118,86,604,157,90,73,514,165
1500000US530330288022,530330288022,"Block Group 2, Census Tract 288.02, King County, Washington",465,106,63,53,52,53,11,22,402,98,35,34,367,104
1500000US530330288023,530330288023,"Block Group 3, Census Tract 288.02, King County, Washington",318,120,129,86,34,47,95,81,189,120,31,50,158,105
1500000US530330288024,530330288024,"Block Group 4, Census Tract 288.02, King County, Washington",640,158,188,107,36,45,152,102,452,150,134,109,318,122
1500000US530330289011,530330289011,"Block Group 1, Census Tract 289.01, King County, Washington",494,96,90,57,40,52,50,39,404,90,64,41,340,88
1500000US530330289012,530330289012,"Block Group 2, Census Tract 289.01, King County, Washington",260,65,12,20,0,12,12,20,248,71,95,63,153,49
1500000US530330289013,530330289013,"Block Group 3, Census Tract 289.01, King County, Washington",335,62,0,12,0,12,0,12,335,62,130,55,205,65
1500000US530330289014,530330289014,"Block Group 4, Census Tract 289.01, King County, Washington",391,75,35,34,0,12,35,34,356,68,21,21,335,69
1500000US530330289021,530330289021,"Block Group 1, Census Tract 289.02, King County, Washington",343,155,225,151,159,123,66,90,118,62,10,15,108,64
1500000US530330289022,530330289022,"Block Group 2, Census Tract 289.02, King County, Washington",534,141,58,54,41,47,17,27,476,145,124,64,352,151
1500000US530330289023,530330289023,"Block Group 3, Census Tract 289.02, King County, Washington",433,121,243,122,68,72,175,101,190,91,77,73,113,60
1500000US530330289024,530330289024,"Block Group 4, Census Tract 289.02, King County, Washington",491,132,110,93,48,78,62,50,381,120,69,58,312,107
1500000US530330289025,530330289025,"Block Group 5, Census Tract 289.02, King County, Washington",558,177,177,119,127,93,50,78,381,150,88,65,293,142
1500000US530330290011,530330290011,"Block Group 1, Census Tract 290.01, King County, Washington",390,60,23,24,14,17,9,15,367,61,144,40,223,56
1500000US530330290012,530330290012,"Block Group 2, Census Tract 290.01, King County, Washington",375,89,51,44,17,19,34,40,324,88,76,59,248,74
1500000US530330290013,530330290013,"Block Group 3, Census Tract 290.01, King County, Washington",391,86,16,19,16,19,0,12,375,87,118,66,257,69
1500000US530330290014,530330290014,"Block Group 4, Census Tract 290.01, King County, Washington",729,84,42,29,34,27,8,13,687,84,191,60,496,91
1500000US530330290031,530330290031,"Block Group 1, Census Tract 290.03, King County, Washington",421,132,125,73,32,34,93,61,296,132,65,84,231,107
1500000US530330290032,530330290032,"Block Group 2, Census Tract 290.03, King County, Washington",403,139,119,106,34,30,85,101,284,130,67,48,217,118
1500000US530330290033,530330290033,"Block Group 3, Census Tract 290.03, King County, Washington",545,136,50,61,0,12,50,61,495,124,85,52,410,123
1500000US530330290034,530330290034,"Block Group 4, Census Tract 290.03, King County, Washington",359,120,59,55,12,16,47,53,300,114,46,46,254,112
1500000US530330290035,530330290035,"Block Group 5, Census Tract 290.03, King County, Washington",251,76,17,25,17,25,0,12,234,75,43,34,191,72
1500000US530330290041,530330290041,"Block Group 1, Census Tract 290.04, King County, Washington",693,86,198,73,50,35,148,71,495,83,133,57,362,82
1500000US530330290042,530330290042,"Block Group 2, Census Tract 290.04, King County, Washington",588,75,245,77,80,43,165,73,343,75,98,58,245,74
1500000US530330291011,530330291011,"Block Group 1, Census Tract 291.01, King County, Washington",492,77,103,69,56,57,47,40,389,71,40,28,349,64
1500000US530330291012,530330291012,"Block Group 2, Census Tract 291.01, King County, Washington",695,82,31,34,7,13,24,32,664,81,180,84,484,73
1500000US530330291021,530330291021,"Block Group 1, Census Tract 291.02, King County, Washington",412,83,50,33,36,32,14,18,362,83,65,46,297,88
1500000US530330291022,530330291022,"Block Group 2, Census Tract 291.02, King County, Washington",373,69,29,27,11,17,18,21,344,76,58,28,286,77
1500000US530330291023,530330291023,"Block Group 3, Census Tract 291.02, King County, Washington",589,104,94,71,8,12,86,71,495,108,98,49,397,105
1500000US530330292031,530330292031,"Block Group 1, Census Tract 292.03, King County, Washington",720,97,286,96,45,34,241,101,434,116,167,74,267,91
1500000US530330292032,530330292032,"Block Group 2, Census Tract 292.03, King County, Washington",452,98,144,79,71,56,73,55,308,74,115,60,193,66
1500000US530330292041,530330292041,"Block Group 1, Census Tract 292.04, King County, Washington",951,187,179,96,60,69,119,81,772,205,242,112,530,182
1500000US530330292042,530330292042,"Block Group 2, Census Tract 292.04, King County, Washington",801,124,134,95,109,85,25,43,667,170,110,97,557,148
1500000US530330292043,530330292043,"Block Group 3, Census Tract 292.04, King County, Washington",261,89,23,36,23,36,0,12,238,82,40,37,198,83
1500000US530330292044,530330292044,"Block Group 4, Census Tract 292.04, King County, Washington",534,165,46,72,0,12,46,72,488,171,0,12,488,171
1500000US530330292051,530330292051,"Block Group 1, Census Tract 292.05, King County, Washington",1107,176,100,68,87,67,13,22,1007,193,105,68,902,190
1500000US530330292052,530330292052,"Block Group 2, Census Tract 292.05, King County, Washington",460,158,194,126,111,103,83,70,266,144,34,39,232,143
1500000US530330292053,530330292053,"Block Group 3, Census Tract 292.05, King County, Washington",591,148,54,61,54,61,0,12,537,147,15,25,522,149
1500000US530330292061,530330292061,"Block Group 1, Census Tract 292.06, King County, Washington",263,79,118,76,43,44,75,62,145,67,50,39,95,58
1500000US530330292062,530330292062,"Block Group 2, Census Tract 292.06, King County, Washington",942,124,400,112,133,66,267,120,542,116,132,62,410,124
1500000US530330292063,530330292063,"Block Group 3, Census Tract 292.06, King County, Washington",617,116,134,73,28,34,106,64,483,110,77,57,406,110
1500000US530330293031,530330293031,"Block Group 1, Census Tract 293.03, King County, Washington",409,93,52,53,0,12,52,53,357,88,92,82,265,84
1500000US530330293032,530330293032,"Block Group 2, Census Tract 293.03, King County, Washington",363,104,111,99,0,12,111,99,252,84,78,49,174,81
1500000US530330293033,530330293033,"Block Group 3, Census Tract 293.03, King County, Washington",1114,161,70,59,18,28,52,51,1044,173,123,65,921,183
1500000US530330293034,530330293034,"Block Group 4, Census Tract 293.03, King County, Washington",535,117,94,78,57,62,37,43,441,127,19,24,422,132
1500000US530330293035,530330293035,"Block Group 5, Census Tract 293.03, King County, Washington",582,128,24,27,9,14,15,23,558,127,123,102,435,90
1500000US530330293041,530330293041,"Block Group 1, Census Tract 293.04, King County, Washington",458,83,47,54,29,45,18,29,411,76,122,41,289,79
1500000US530330293042,530330293042,"Block Group 2, Census Tract 293.04, King County, Washington",402,58,0,12,0,12,0,12,402,58,47,45,355,58
1500000US530330293043,530330293043,"Block Group 3, Census Tract 293.04, King County, Washington",581,106,15,19,6,10,9,16,566,105,74,49,492,103
1500000US530330293044,530330293044,"Block Group 4, Census Tract 293.04, King County, Washington",360,57,9,14,0,12,9,14,351,58,47,30,304,68
1500000US530330293051,530330293051,"Block Group 1, Census Tract 293.05, King County, Washington",280,63,15,21,15,21,0,12,265,65,45,31,220,61
1500000US530330293052,530330293052,"Block Group 2, Census Tract 293.05, King County, Washington",503,91,254,95,129,78,125,100,249,60,61,44,188,54
1500000US530330293053,530330293053,"Block Group 3, Census Tract 293.05, King County, Washington",294,62,26,21,17,20,9,15,268,56,44,38,224,59
1500000US530330293054,530330293054,"Block Group 4, Census Tract 293.05, King County, Washington",261,55,25,29,0,12,25,29,236,59,54,35,182,58
1500000US530330293061,530330293061,"Block Group 1, Census Tract 293.06, King County, Washington",780,76,77,40,12,20,65,35,703,85,159,55,544,80
1500000US530330293062,530330293062,"Block Group 2, Census Tract 293.06, King County, Washington",449,61,21,18,13,19,8,12,428,59,75,44,353,68
1500000US530330293071,530330293071,"Block Group 1, Census Tract 293.07, King County, Washington",290,48,17,18,9,14,8,12,273,53,94,39,179,57
1500000US530330293072,530330293072,"Block Group 2, Census Tract 293.07, King County, Washington",531,58,50,32,24,21,26,23,481,66,66,35,415,75
1500000US530330293073,530330293073,"Block Group 3, Census Tract 293.07, King County, Washington",468,63,83,61,11,16,72,60,385,69,50,37,335,77
1500000US530330294031,530330294031,"Block Group 1, Census Tract 294.03, King County, Washington",629,89,82,44,51,41,31,22,547,95,119,50,428,104
1500000US530330294032,530330294032,"Block Group 2, Census Tract 294.03, King County, Washington",371,84,0,12,0,12,0,12,371,84,57,43,314,74
1500000US530330294033,530330294033,"Block Group 3, Census Tract 294.03, King County, Washington",837,116,199,102,115,86,84,56,638,101,107,64,531,99
1500000US530330294051,530330294051,"Block Group 1, Census Tract 294.05, King County, Washington",302,68,36,29,29,32,7,11,266,71,58,43,208,64
1500000US530330294052,530330294052,"Block Group 2, Census Tract 294.05, King County, Washington",516,86,54,38,21,24,33,31,462,91,77,61,385,94
1500000US530330294053,530330294053,"Block Group 3, Census Tract 294.05, King County, Washington",268,54,13,20,4,13,9,17,255,50,49,32,206,55
1500000US530330294054,530330294054,"Block Group 4, Census Tract 294.05, King County, Washington",309,76,20,33,0,12,20,33,289,70,16,25,273,71
1500000US530330294055,530330294055,"Block Group 5, Census Tract 294.05, King County, Washington",377,65,30,27,22,24,8,13,347,66,50,34,297,66
1500000US530330294061,530330294061,"Block Group 1, Census Tract 294.06, King County, Washington",680,102,103,55,46,36,57,43,577,104,107,80,470,92
1500000US530330294062,530330294062,"Block Group 2, Census Tract 294.06, King County, Washington",923,100,103,73,29,29,74,70,820,101,161,82,659,88
1500000US530330294071,530330294071,"Block Group 1, Census Tract 294.07, King County, Washington",417,93,87,49,25,24,62,40,330,87,80,50,250,81
1500000US530330294072,530330294072,"Block Group 2, Census Tract 294.07, King County, Washington",775,94,264,84,101,54,163,76,511,104,56,38,455,107
1500000US530330294073,530330294073,"Block Group 3, Census Tract 294.07, King County, Washington",354,67,20,23,0,12,20,23,334,66,116,49,218,74
1500000US530330294081,530330294081,"Block Group 1, Census Tract 294.08, King County, Washington",385,90,69,41,30,28,39,33,316,90,77,36,239,80
1500000US530330294082,530330294082,"Block Group 2, Census Tract 294.08, King County, Washington",423,71,26,28,18,25,8,13,397,80,41,29,356,78
1500000US530330294083,530330294083,"Block Group 3, Census Tract 294.08, King County, Washington",759,101,241,84,61,40,180,81,518,114,56,41,462,113
1500000US530330295021,530330295021,"Block Group 1, Census Tract 295.02, King County, Washington",762,133,128,71,63,54,65,44,634,148,161,97,473,119
1500000US530330295022,530330295022,"Block Group 2, Census Tract 295.02, King County, Washington",372,93,32,39,18,31,14,23,340,100,49,48,291,105
1500000US530330295023,530330295023,"Block Group 3, Census Tract 295.02, King County, Washington",393,111,31,39,27,38,4,10,362,107,0,12,362,107
1500000US530330295024,530330295024,"Block Group 4, Census Tract 295.02, King County, Washington",455,111,69,52,55,46,14,24,386,115,47,45,339,112
1500000US530330295031,530330295031,"Block Group 1, Census Tract 295.03, King County, Washington",370,100,78,59,44,46,34,42,292,98,23,29,269,102
1500000US530330295032,530330295032,"Block Group 2, Census Tract 295.03, King County, Washington",960,197,216,132,43,40,173,120,744,202,231,130,513,166
1500000US530330295033,530330295033,"Block Group 3, Census Tract 295.03, King County, Washington",685,167,416,152,135,72,281,138,269,110,59,52,210,101
1500000US530330295034,530330295034,"Block Group 4, Census Tract 295.03, King County, Washington",207,74,70,69,70,69,0,12,137,57,11,16,126,53
1500000US530330295035,530330295035,"Block Group 5, Census Tract 295.03, King County, Washington",745,190,258,121,86,72,172,106,487,172,130,110,357,157
1500000US530330295041,530330295041,"Block Group 1, Census Tract 295.04, King County, Washington",697,131,260,136,52,55,208,120,437,126,174,80,263,118
1500000US530330295042,530330295042,"Block Group 2, Census Tract 295.04, King County, Washington",524,128,167,118,121,107,46,44,357,108,75,48,282,109
1500000US530330295043,530330295043,"Block Group 3, Census Tract 295.04, King County, Washington",932,155,160,125,29,32,131,117,772,145,156,79,616,141
1500000US530330296011,530330296011,"Block Group 1, Census Tract 296.01, King County, Washington",463,127,126,83,33,32,93,81,337,102,87,64,250,99
1500000US530330296012,530330296012,"Block Group 2, Census Tract 296.01, King County, Washington",354,85,66,53,13,20,53,50,288,82,0,12,288,82
1500000US530330296013,530330296013,"Block Group 3, Census Tract 296.01, King County, Washington",435,91,182,83,108,65,74,57,253,77,48,38,205,73
1500000US530330296014,530330296014,"Block Group 4, Census Tract 296.01, King County, Washington",292,73,27,20,27,20,0,12,265,75,73,53,192,60
1500000US530330296015,530330296015,"Block Group 5, Census Tract 296.01, King County, Washington",360,107,55,46,16,31,39,35,305,105,11,17,294,107
1500000US530330296021,530330296021,"Block Group 1, Census Tract 296.02, King County, Washington",397,63,0,12,0,12,0,12,397,63,86,46,311,68
1500000US530330296022,530330296022,"Block Group 2, Census Tract 296.02, King County, Washington",487,96,0,12,0,12,0,12,487,96,39,38,448,92
1500000US530330296023,530330296023,"Block Group 3, Census Tract 296.02, King County, Washington",803,85,79,53,12,18,67,49,724,85,66,43,658,90
1500000US530330297001,530330297001,"Block Group 1, Census Tract 297, King County, Washington",624,104,31,36,31,36,0,12,593,109,233,90,360,113
1500000US530330297002,530330297002,"Block Group 2, Census Tract 297, King County, Washington",681,132,123,81,29,34,94,73,558,132,125,58,433,137
1500000US530330297003,530330297003,"Block Group 3, Census Tract 297, King County, Washington",782,173,349,128,193,95,156,103,433,135,102,89,331,122
1500000US530330297004,530330297004,"Block Group 4, Census Tract 297, King County, Washington",399,135,91,61,56,51,35,35,308,135,69,51,239,124
1500000US530330297005,530330297005,"Block Group 5, Census Tract 297, King County, Washington",461,99,254,127,84,57,170,127,207,86,59,48,148,80
1500000US530330298011,530330298011,"Block Group 1, Census Tract 298.01, King County, Washington",394,98,64,47,54,43,10,19,330,90,76,46,254,86
1500000US530330298012,530330298012,"Block Group 2, Census Tract 298.01, King County, Washington",699,140,40,37,14,22,26,30,659,148,81,68,578,146
1500000US530330298013,530330298013,"Block Group 3, Census Tract 298.01, King County, Washington",479,107,82,63,13,22,69,59,397,105,109,80,288,88
1500000US530330298014,530330298014,"Block Group 4, Census Tract 298.01, King County, Washington",474,112,70,55,0,12,70,55,404,108,70,47,334,110
1500000US530330298015,530330298015,"Block Group 5, Census Tract 298.01, King County, Washington",912,161,299,139,113,74,186,130,613,144,143,94,470,148
1500000US530330298021,530330298021,"Block Group 1, Census Tract 298.02, King County, Washington",385,88,26,32,0,12,26,32,359,96,98,60,261,114
1500000US530330298022,530330298022,"Block Group 2, Census Tract 298.02, King County, Washington",479,156,61,102,61,102,0,12,418,121,88,59,330,136
1500000US530330298023,530330298023,"Block Group 3, Census Tract 298.02, King County, Washington",869,169,56,45,28,32,28,31,813,173,74,61,739,170
1500000US530330298024,530330298024,"Block Group 4, Census Tract 298.02, King County, Washington",330,107,84,104,63,101,21,38,246,68,83,60,163,72
1500000US530330298025,530330298025,"Block Group 5, Census Tract 298.02, King County, Washington",494,98,31,36,31,36,0,12,463,92,73,61,390,87
1500000US530330298026,530330298026,"Block Group 6, Census Tract 298.02, King County, Washington",545,106,9,16,9,16,0,12,536,107,107,65,429,97
1500000US530330299011,530330299011,"Block Group 1, Census Tract 299.01, King County, Washington",639,104,16,25,0,12,16,25,623,102,134,55,489,109
1500000US530330299012,530330299012,"Block Group 2, Census Tract 299.01, King County, Washington",439,86,51,39,0,12,51,39,388,88,94,53,294,88
1500000US530330299013,530330299013,"Block Group 3, Census Tract 299.01, King County, Washington",555,81,170,81,76,57,94,74,385,86,70,42,315,77
1500000US530330299021,530330299021,"Block Group 1, Census Tract 299.02, King County, Washington",405,69,53,44,53,44,0,12,352,74,30,26,322,77
1500000US530330299022,530330299022,"Block Group 2, Census Tract 299.02, King County, Washington",406,66,18,22,12,19,6,11,388,68,92,56,296,59
1500000US530330299023,530330299023,"Block Group 3, Census Tract 299.02, King County, Washington",678,77,12,19,0,12,12,19,666,78,79,43,587,86
1500000US530330300031,530330300031,"Block Group 1, Census Tract 300.03, King County, Washington",390,106,21,30,21,30,0,12,369,113,119,81,250,89
1500000US530330300032,530330300032,"Block Group 2, Census Tract 300.03, King County, Washington",703,161,182,110,120,91,62,59,521,143,123,85,398,125
1500000US530330300033,530330300033,"Block Group 3, Census Tract 300.03, King County, Washington",261,99,64,69,21,32,43,61,197,79,20,24,177,78
1500000US530330300034,530330300034,"Block Group 4, Census Tract 300.03, King County, Washington",332,80,0,12,0,12,0,12,332,80,27,31,305,86
1500000US530330300035,530330300035,"Block Group 5, Census Tract 300.03, King County, Washington",515,149,43,65,43,65,0,12,472,149,87,67,385,136
1500000US530330300041,530330300041,"Block Group 1, Census Tract 300.04, King County, Washington",395,103,160,100,71,59,89,85,235,90,44,43,191,84
1500000US530330300042,530330300042,"Block Group 2, Census Tract 300.04, King County, Washington",811,196,96,66,61,53,35,40,715,200,70,55,645,209
1500000US530330300043,530330300043,"Block Group 3, Census Tract 300.04, King County, Washington",449,160,53,51,0,12,53,51,396,160,51,54,345,145
1500000US530330300044,530330300044,"Block Group 4, Census Tract 300.04, King County, Washington",285,88,14,21,5,13,9,16,271,90,57,50,214,94
1500000US530330300045,530330300045,"Block Group 5, Census Tract 300.04, King County, Washington",698,178,421,177,219,153,202,130,277,149,65,82,212,127
1500000US530330300046,530330300046,"Block Group 6, Census Tract 300.04, King County, Washington",420,121,167,71,90,77,77,77,253,107,42,47,211,103
1500000US530330300051,530330300051,"Block Group 1, Census Tract 300.05, King County, Washington",536,107,103,56,62,40,41,42,433,103,132,65,301,101
1500000US530330300052,530330300052,"Block Group 2, Census Tract 300.05, King County, Washington",569,93,99,60,20,24,79,55,470,84,64,38,406,84
1500000US530330300053,530330300053,"Block Group 3, Census Tract 300.05, King County, Washington",725,121,315,110,142,71,173,89,410,115,47,37,363,113
1500000US530330300061,530330300061,"Block Group 1, Census Tract 300.06, King County, Washington",543,109,155,71,104,65,51,37,388,96,113,64,275,90
1500000US530330300062,530330300062,"Block Group 2, Census Tract 300.06, King County, Washington",1135,115,447,127,202,86,245,101,688,136,312,98,376,118
1500000US530330301001,530330301001,"Block Group 1, Census Tract 301, King County, Washington",308,60,40,48,40,48,0,12,268,63,134,73,134,70
1500000US530330301002,530330301002,"Block Group 2, Census Tract 301, King County, Washington",369,108,24,32,24,32,0,12,345,104,45,41,300,103
1500000US530330301003,530330301003,"Block Group 3, Census Tract 301, King County, Washington",628,103,9,14,9,14,0,12,619,103,75,56,544,107
1500000US530330301004,530330301004,"Block Group 4, Census Tract 301, King County, Washington",268,84,0,12,0,12,0,12,268,84,74,57,194,71
1500000US530330301005,530330301005,"Block Group 5, Census Tract 301, King County, Washington",356,115,170,88,0,12,170,88,186,100,40,38,146,97
1500000US530330301006,530330301006,"Block Group 6, Census Tract 301, King County, Washington",445,99,0,12,0,12,0,12,445,99,188,101,257,95
1500000US530330301007,530330301007,"Block Group 7, Census Tract 301, King County, Washington",433,114,24,38,24,38,0,12,409,117,104,93,305,83
1500000US530330302011,530330302011,"Block Group 1, Census Tract 302.01, King County, Washington",256,98,74,60,7,12,67,61,182,74,32,28,150,70
1500000US530330302012,530330302012,"Block Group 2, Census Tract 302.01, King County, Washington",465,124,106,86,45,53,61,66,359,101,72,73,287,89
1500000US530330302013,530330302013,"Block Group 3, Census Tract 302.01, King County, Washington",547,120,31,31,23,27,8,15,516,120,59,73,457,113
1500000US530330302014,530330302014,"Block Group 4, Census Tract 302.01, King County, Washington",757,139,105,89,11,18,94,85,652,135,114,66,538,134
1500000US530330302021,530330302021,"Block Group 1, Census Tract 302.02, King County, Washington",301,92,49,58,24,37,25,44,252,84,69,62,183,69
1500000US530330302022,530330302022,"Block Group 2, Census Tract 302.02, King County, Washington",614,122,87,81,41,53,46,64,527,121,207,91,320,127
1500000US530330302023,530330302023,"Block Group 3, Census Tract 302.02, King County, Washington",283,91,81,53,0,12,81,53,202,96,50,55,152,85
1500000US530330302024,530330302024,"Block Group 4, Census Tract 302.02, King County, Washington",495,136,132,98,86,83,46,56,363,123,75,73,288,111
1500000US530330302025,530330302025,"Block Group 5, Census Tract 302.02, King County, Washington",615,156,83,83,11,18,72,78,532,158,188,91,344,142
1500000US530330303041,530330303041,"Block Group 1, Census Tract 303.04, King County, Washington",568,64,52,37,33,24,19,23,516,71,96,35,420,74
1500000US530330303042,530330303042,"Block Group 2, Census Tract 303.04, King County, Washington",439,72,87,39,64,36,23,23,352,65,66,38,286,67
1500000US530330303051,530330303051,"Block Group 1, Census Tract 303.05, King County, Washington",919,151,216,133,68,81,148,115,703,134,97,57,606,139
1500000US530330303052,530330303052,"Block Group 2, Census Tract 303.05, King County, Washington",618,139,48,51,34,44,14,24,570,134,148,86,422,127
1500000US530330303053,530330303053,"Block Group 3, Census Tract 303.05, King County, Washington",567,124,66,70,0,12,66,70,501,100,161,83,340,94
1500000US530330303061,530330303061,"Block Group 1, Census Tract 303.06, King County, Washington",450,86,83,43,21,20,62,41,367,77,90,52,277,69
1500000US530330303062,530330303062,"Block Group 2, Census Tract 303.06, King County, Washington",358,83,9,16,0,12,9,16,349,82,90,55,259,78
1500000US530330303063,530330303063,"Block Group 3, Census Tract 303.06, King County, Washington",822,98,108,56,74,47,34,28,714,108,183,76,531,113
1500000US530330303064,530330303064,"Block Group 4, Census Tract 303.06, King County, Washington",444,88,37,29,17,19,20,22,407,91,107,50,300,94
1500000US530330303081,530330303081,"Block Group 1, Census Tract 303.08, King County, Washington",258,72,9,14,0,12,9,14,249,73,47,49,202,69
1500000US530330303082,530330303082,"Block Group 2, Census Tract 303.08, King County, Washington",727,158,177,110,131,95,46,52,550,156,70,63,480,157
1500000US530330303083,530330303083,"Block Group 3, Census Tract 303.08, King County, Washington",467,92,50,60,50,60,0,12,417,96,26,30,391,98
1500000US530330303084,530330303084,"Block Group 4, Census Tract 303.08, King County, Washington",814,160,101,82,0,12,101,82,713,172,164,94,549,182
1500000US530330303091,530330303091,"Block Group 1, Census Tract 303.09, King County, Washington",408,97,34,39,0,12,34,39,374,101,51,59,323,114
1500000US530330303092,530330303092,"Block Group 2, Census Tract 303.09, King County, Washington",627,170,107,93,48,77,59,54,520,168,44,50,476,161
1500000US530330303093,530330303093,"Block Group 3, Census Tract 303.09, King County, Washington",581,147,119,85,40,47,79,72,462,151,42,67,420,134
1500000US530330303094,530330303094,"Block Group 4, Census Tract 303.09, King County, Washington",789,179,119,101,110,97,9,24,670,171,61,59,609,171
1500000US530330303101,530330303101,"Block Group 1, Census Tract 303.10, King County, Washington",303,77,54,40,8,13,46,38,249,81,21,26,228,79
1500000US530330303102,530330303102,"Block Group 2, Census Tract 303.10, King County, Washington",305,60,30,32,14,22,16,22,275,60,51,32,224,57
1500000US530330303103,530330303103,"Block Group 3, Census Tract 303.10, King County, Washington",477,80,12,20,12,20,0,12,465,80,55,45,410,93
1500000US530330303104,530330303104,"Block Group 4, Census Tract 303.10, King County, Washington",830,104,78,67,0,12,78,67,752,101,293,102,459,100
1500000US530330303111,530330303111,"Block Group 1, Census Tract 303.11, King County, Washington",372,88,21,23,0,12,21,23,351,87,33,31,318,90
1500000US530330303112,530330303112,"Block Group 2, Census Tract 303.11, King County, Washington",596,111,176,118,63,67,113,100,420,119,59,64,361,125
1500000US530330303113,530330303113,"Block Group 3, Census Tract 303.11, King County, Washington",421,70,51,33,21,21,30,29,370,70,119,61,251,67
1500000US530330303114,530330303114,"Block Group 4, Census Tract 303.11, King County, Washington",322,86,77,73,9,16,68,68,245,81,45,30,200,81
1500000US530330303121,530330303121,"Block Group 1, Census Tract 303.12, King County, Washington",651,117,176,96,109,75,67,60,475,111,146,88,329,96
1500000US530330303122,530330303122,"Block Group 2, Census Tract 303.12, King County, Washington",503,105,44,39,44,39,0,12,459,108,134,84,325,91
1500000US530330303123,530330303123,"Block Group 3, Census Tract 303.12, King County, Washington",336,65,62,35,14,19,48,33,274,59,37,35,237,56
1500000US530330303124,530330303124,"Block Group 4, Census Tract 303.12, King County, Washington",281,66,13,18,10,16,3,8,268,65,35,26,233,63
1500000US530330303131,530330303131,"Block Group 1, Census Tract 303.13, King County, Washington",721,109,155,78,49,38,106,70,566,119,137,62,429,124
1500000US530330303132,530330303132,"Block Group 2, Census Tract 303.13, King County, Washington",1005,126,319,135,207,102,112,102,686,135,119,81,567,141
1500000US530330303141,530330303141,"Block Group 1, Census Tract 303.14, King County, Washington",900,135,334,142,154,87,180,120,566,124,162,90,404,97
1500000US530330303142,530330303142,"Block Group 2, Census Tract 303.14, King County, Washington",365,95,88,82,38,35,50,73,277,80,98,52,179,72
1500000US530330303143,530330303143,"Block Group 3, Census Tract 303.14, King County, Washington",643,115,144,85,72,56,72,66,499,91,201,77,298,84
1500000US530330304011,530330304011,"Block Group 1, Census Tract 304.01, King County, Washington",795,156,129,66,32,41,97,66,666,150,74,59,592,150
1500000US530330304012,530330304012,"Block Group 2, Census Tract 304.01, King County, Washington",506,131,19,17,11,19,8,13,487,130,120,67,367,127
1500000US530330304013,530330304013,"Block Group 3, Census Tract 304.01, King County, Washington",541,142,81,58,30,47,51,48,460,152,91,64,369,148
1500000US530330304014,530330304014,"Block Group 4, Census Tract 304.01, King County, Washington",518,132,12,19,0,12,12,19,506,131,116,101,390,129
1500000US530330304015,530330304015,"Block Group 5, Census Tract 304.01, King County, Washington",607,181,76,50,35,41,41,45,531,182,50,56,481,189
1500000US530330304031,530330304031,"Block Group 1, Census Tract 304.03, King County, Washington",702,88,103,74,38,44,65,64,599,86,213,87,386,83
1500000US530330304032,530330304032,"Block Group 2, Census Tract 304.03, King County, Washington",382,70,13,16,5,9,8,14,369,72,56,31,313,73
1500000US530330304033,530330304033,"Block Group 3, Census Tract 304.03, King County, Washington",592,77,35,34,25,32,10,15,557,85,90,43,467,82
1500000US530330304041,530330304041,"Block Group 1, Census Tract 304.04, King County, Washington",625,83,57,46,10,16,47,43,568,82,131,43,437,88
1500000US530330304042,530330304042,"Block Group 2, Census Tract 304.04, King County, Washington",481,71,37,27,18,21,19,19,444,80,77,40,367,77
1500000US530330304043,530330304043,"Block Group 3, Census Tract 304.04, King County, Washington",477,86,12,18,12,18,0,12,465,87,169,92,296,84
1500000US530330305011,530330305011,"Block Group 1, Census Tract 305.01, King County, Washington",345,57,121,45,52,25,69,44,224,45,50,26,174,50
1500000US530330305012,530330305012,"Block Group 2, Census Tract 305.01, King County, Washington",578,60,226,59,112,38,114,47,352,70,110,45,242,66
1500000US530330305031,530330305031,"Block Group 1, Census Tract 305.03, King County, Washington",1040,147,317,109,185,85,132,92,723,140,189,78,534,126
1500000US530330305032,530330305032,"Block Group 2, Census Tract 305.03, King County, Washington",1099,145,147,89,41,27,106,86,952,136,205,65,747,120
1500000US530330305041,530330305041,"Block Group 1, Census Tract 305.04, King County, Washington",368,85,59,58,20,23,39,52,309,91,34,21,275,92
1500000US530330305042,530330305042,"Block Group 2, Census Tract 305.04, King County, Washington",493,105,86,53,33,28,53,55,407,102,92,51,315,103
1500000US530330305043,530330305043,"Block Group 3, Census Tract 305.04, King County, Washington",381,100,170,86,78,51,92,69,211,61,33,29,178,58
1500000US530330305044,530330305044,"Block Group 4, Census Tract 305.04, King County, Washington",692,122,121,86,43,38,78,82,571,115,163,53,408,108
1500000US530330306001,530330306001,"Block Group 1, Census Tract 306, King County, Washington",434,124,114,107,46,70,68,77,320,113,39,44,281,105
1500000US530330306002,530330306002,"Block Group 2, Census Tract 306, King County, Washington",607,122,129,81,16,25,113,75,478,131,76,46,402,131
1500000US530330306003,530330306003,"Block Group 3, Census Tract 306, King County, Washington",440,113,106,67,56,53,50,40,334,118,113,89,221,98
1500000US530330306004,530330306004,"Block Group 4, Census Tract 306, King County, Washington",638,124,262,113,97,62,165,96,376,127,209,113,167,86
1500000US530330307001,530330307001,"Block Group 1, Census Tract 307, King County, Washington",540,96,162,73,89,62,73,50,378,102,27,23,351,100
1500000US530330307002,530330307002,"Block Group 2, Census Tract 307, King County, Washington",493,77,83,33,39,25,44,32,410,77,127,57,283,73
1500000US530330307003,530330307003,"Block Group 3, Census Tract 307, King County, Washington",459,98,70,45,33,29,37,37,389,95,105,55,284,93
1500000US530330308011,530330308011,"Block Group 1, Census Tract 308.01, King County, Washington",631,128,259,116,155,108,104,107,372,107,83,63,289,98
1500000US530330308012,530330308012,"Block Group 2, Census Tract 308.01, King County, Washington",707,133,445,112,260,106,185,95,262,97,73,65,189,82
1500000US530330308013,530330308013,"Block Group 3, Census Tract 308.01, King County, Washington",1099,142,390,152,90,65,300,144,709,164,163,88,546,156
1500000US530330308021,530330308021,"Block Group 1, Census Tract 308.02, King County, Washington",450,82,122,57,70,43,52,48,328,83,39,30,289,84
1500000US530330308022,530330308022,"Block Group 2, Census Tract 308.02, King County, Washington",560,104,134,62,19,23,115,62,426,90,171,89,255,77
1500000US530330308023,530330308023,"Block Group 3, Census Tract 308.02, King County, Washington",362,75,71,40,39,35,32,29,291,82,17,15,274,84
1500000US530330309011,530330309011,"Block Group 1, Census Tract 309.01, King County, Washington",593,90,82,34,40,26,42,27,511,95,134,58,377,78
1500000US530330309012,530330309012,"Block Group 2, Census Tract 309.01, King County, Washington",507,82,149,76,65,43,84,63,358,85,81,44,277,76
1500000US530330309021,530330309021,"Block Group 1, Census Tract 309.02, King County, Washington",883,115,241,98,136,91,105,57,642,128,268,106,374,91
1500000US530330309022,530330309022,"Block Group 2, Census Tract 309.02, King County, Washington",481,91,100,66,22,24,78,67,381,90,70,43,311,89
1500000US530330309023,530330309023,"Block Group 3, Census Tract 309.02, King County, Washington",702,140,169,86,46,32,123,81,533,126,34,33,499,122
1500000US530330310001,530330310001,"Block Group 1, Census Tract 310, King County, Washington",778,88,21,28,0,12,21,28,757,87,132,55,625,90
1500000US530330310002,530330310002,"Block Group 2, Census Tract 310, King County, Washington",579,76,20,23,20,23,0,12,559,76,49,32,510,83
1500000US530330311001,530330311001,"Block Group 1, Census Tract 311, King County, Washington",434,107,79,56,15,23,64,50,355,110,156,99,199,79
1500000US530330311002,530330311002,"Block Group 2, Census Tract 311, King County, Washington",487,78,93,71,70,69,23,20,394,73,122,54,272,78
1500000US530330311003,530330311003,"Block Group 3, Census Tract 311, King County, Washington",669,94,113,32,45,21,68,22,556,84,159,42,397,89
1500000US530330311004,530330311004,"Block Group 4, Census Tract 311, King County, Washington",543,117,128,81,57,50,71,65,415,104,155,73,260,82
1500000US530330311005,530330311005,"Block Group 5, Census Tract 311, King County, Washington",474,93,192,78,77,51,115,59,282,87,94,67,188,63
1500000US530330312021,530330312021,"Block Group 1, Census Tract 312.02, King County, Washington",415,101,9,15,9,15,0,12,406,106,53,44,353,118
1500000US530330312022,530330312022,"Block Group 2, Census Tract 312.02, King County, Washington",357,70,40,41,35,40,5,9,317,79,53,68,264,102
1500000US530330312023,530330312023,"Block Group 3, Census Tract 312.02, King County, Washington",380,85,12,20,0,12,12,20,368,84,95,63,273,69
1500000US530330312024,530330312024,"Block Group 4, Census Tract 312.02, King County, Washington",533,88,14,25,14,25,0,12,519,90,100,86,419,87
1500000US530330312025,530330312025,"Block Group 5, Census Tract 312.02, King County, Washington",527,108,150,49,71,29,79,39,377,105,119,57,258,96
1500000US530330312041,530330312041,"Block Group 1, Census Tract 312.04, King County, Washington",417,118,17,28,17,28,0,12,400,128,77,58,323,130
1500000US530330312042,530330312042,"Block Group 2, Census Tract 312.04, King County, Washington",430,84,0,12,0,12,0,12,430,84,69,56,361,94
1500000US530330312043,530330312043,"Block Group 3, Census Tract 312.04, King County, Washington",524,98,33,39,0,12,33,39,491,106,143,69,348,126
1500000US530330312044,530330312044,"Block Group 4, Census Tract 312.04, King County, Washington",317,91,0,12,0,12,0,12,317,91,135,61,182,97
1500000US530330312045,530330312045,"Block Group 5, Census Tract 312.04, King County, Washington",518,126,0,12,0,12,0,12,518,126,146,98,372,136
1500000US530330312051,530330312051,"Block Group 1, Census Tract 312.05, King County, Washington",895,163,220,134,48,80,172,120,675,144,17,28,658,141
1500000US530330312052,530330312052,"Block Group 2, Census Tract 312.05, King County, Washington",853,141,208,119,164,120,44,48,645,148,133,80,512,145
1500000US530330312053,530330312053,"Block Group 3, Census Tract 312.05, King County, Washington",519,113,80,82,64,76,16,25,439,96,27,32,412,93
1500000US530330312061,530330312061,"Block Group 1, Census Tract 312.06, King County, Washington",450,94,103,71,36,41,67,55,347,85,87,59,260,84
1500000US530330312062,530330312062,"Block Group 2, Census Tract 312.06, King County, Washington",636,80,16,18,8,12,8,13,620,76,231,71,389,69
1500000US530330312063,530330312063,"Block Group 3, Census Tract 312.06, King County, Washington",654,85,142,77,55,55,87,64,512,85,67,40,445,83
1500000US530330313011,530330313011,"Block Group 1, Census Tract 313.01, King County, Washington",491,60,17,14,0,12,17,14,474,64,71,34,403,66
1500000US530330313012,530330313012,"Block Group 2, Census Tract 313.01, King County, Washington",499,67,16,14,0,12,16,14,483,70,73,32,410,71
1500000US530330313021,530330313021,"Block Group 1, Census Tract 313.02, King County, Washington",359,68,8,11,0,12,8,11,351,70,59,50,292,61
1500000US530330313022,530330313022,"Block Group 2, Census Tract 313.02, King County, Washington",381,82,41,43,5,9,36,41,340,71,41,31,299,75
1500000US530330313023,530330313023,"Block Group 3, Census Tract 313.02, King County, Washington",406,60,54,37,45,33,9,15,352,68,129,52,223,59
1500000US530330313024,530330313024,"Block Group 4, Census Tract 313.02, King County, Washington",464,81,127,56,41,39,86,46,337,80,51,43,286,78
1500000US530330314001,530330314001,"Block Group 1, Census Tract 314, King County, Washington",302,116,84,61,84,61,0,12,218,100,21,27,197,97
1500000US530330314002,530330314002,"Block Group 2, Census Tract 314, King County, Washington",650,140,56,37,12,19,44,33,594,149,105,67,489,154
1500000US530330314003,530330314003,"Block Group 3, Census Tract 314, King County, Washington",486,84,63,42,42,30,21,31,423,87,92,54,331,98
1500000US530330314004,530330314004,"Block Group 4, Census Tract 314, King County, Washington",505,132,130,113,93,116,37,42,375,129,65,57,310,136
1500000US530330314005,530330314005,"Block Group 5, Census Tract 314, King County, Washington",394,111,159,112,26,32,133,114,235,78,53,36,182,77
1500000US530330315011,530330315011,"Block Group 1, Census Tract 315.01, King County, Washington",428,101,74,74,74,74,0,12,354,93,101,63,253,91
1500000US530330315012,530330315012,"Block Group 2, Census Tract 315.01, King County, Washington",602,100,33,30,7,11,26,28,569,100,141,61,428,98
1500000US530330315013,530330315013,"Block Group 3, Census Tract 315.01, King County, Washington",479,114,27,27,0,12,27,27,452,114,186,97,266,111
1500000US530330315021,530330315021,"Block Group 1, Census Tract 315.02, King County, Washington",508,113,75,60,41,35,34,50,433,110,37,30,396,111
1500000US530330315022,530330315022,"Block Group 2, Census Tract 315.02, King County, Washington",552,93,39,51,29,46,10,16,513,90,150,56,363,93
1500000US530330315023,530330315023,"Block Group 3, Census Tract 315.02, King County, Washington",682,101,57,47,42,43,15,18,625,112,162,68,463,106
1500000US530330316011,530330316011,"Block Group 1, Census Tract 316.01, King County, Washington",766,74,46,49,16,22,30,45,720,79,82,55,638,80
1500000US530330316012,530330316012,"Block Group 2, Census Tract 316.01, King County, Washington",745,89,43,34,11,16,32,30,702,90,183,80,519,107
1500000US530330316013,530330316013,"Block Group 3, Census Tract 316.01, King County, Washington",465,77,91,70,37,40,54,55,374,70,54,35,320,68
1500000US530330316031,530330316031,"Block Group 1, Census Tract 316.03, King County, Washington",573,88,83,66,27,23,56,62,490,86,58,54,432,81
1500000US530330316032,530330316032,"Block Group 2, Census Tract 316.03, King County, Washington",383,91,0,12,0,12,0,12,383,91,120,89,263,80
1500000US530330316033,530330316033,"Block Group 3, Census Tract 316.03, King County, Washington",557,102,10,16,0,12,10,16,547,102,49,37,498,104
1500000US530330316034,530330316034,"Block Group 4, Census Tract 316.03, King County, Washington",529,89,0,12,0,12,0,12,529,89,58,41,471,88
1500000US530330316041,530330316041,"Block Group 1, Census Tract 316.04, King County, Washington",917,102,36,27,0,12,36,27,881,103,151,57,730,113
1500000US530330316042,530330316042,"Block Group 2, Census Tract 316.04, King County, Washington",301,66,18,28,0,12,18,28,283,62,25,25,258,67
1500000US530330316043,530330316043,"Block Group 3, Census Tract 316.04, King County, Washington",497,92,24,38,24,38,0,12,473,93,100,63,373,88
1500000US530330316051,530330316051,"Block Group 1, Census Tract 316.05, King County, Washington",458,76,23,35,23,35,0,12,435,76,85,48,350,82
1500000US530330316052,530330316052,"Block Group 2, Census Tract 316.05, King County, Washington",442,99,36,36,12,19,24,29,406,99,28,28,378,101
1500000US530330316053,530330316053,"Block Group 3, Census Tract 316.05, King County, Washington",400,80,8,13,0,12,8,13,392,82,63,49,329,83
1500000US530330317031,530330317031,"Block Group 1, Census Tract 317.03, King County, Washington",474,94,9,16,0,12,9,16,465,95,48,50,417,94
1500000US530330317032,530330317032,"Block Group 2, Census Tract 317.03, King County, Washington",475,89,0,12,0,12,0,12,475,89,38,42,437,90
1500000US530330317033,530330317033,"Block Group 3, Census Tract 317.03, King County, Washington",565,105,116,84,50,42,66,71,449,86,113,70,336,96
1500000US530330317034,530330317034,"Block Group 4, Census Tract 317.03, King County, Washington",505,112,64,49,44,36,20,31,441,106,77,53,364,102
1500000US530330317035,530330317035,"Block Group 5, Census Tract 317.03, King County, Washington",673,111,0,12,0,12,0,12,673,111,90,53,583,123
1500000US530330317041,530330317041,"Block Group 1, Census Tract 317.04, King County, Washington",444,82,48,37,26,30,22,27,396,80,46,27,350,80
1500000US530330317042,530330317042,"Block Group 2, Census Tract 317.04, King County, Washington",550,85,84,47,13,14,71,48,466,83,73,50,393,69
1500000US530330317043,530330317043,"Block Group 3, Census Tract 317.04, King County, Washington",736,99,103,58,56,47,47,38,633,102,88,50,545,98
1500000US530330317051,530330317051,"Block Group 1, Census Tract 317.05, King County, Washington",378,89,20,20,12,14,8,14,358,92,24,20,334,93
1500000US530330317052,530330317052,"Block Group 2, Census Tract 317.05, King County, Washington",462,87,19,30,0,12,19,30,443,87,81,46,362,88
1500000US530330317053,530330317053,"Block Group 3, Census Tract 317.05, King County, Washington",486,86,32,29,17,20,15,21,454,80,39,38,415,78
1500000US530330317061,530330317061,"Block Group 1, Census Tract 317.06, King County, Washington",398,116,0,12,0,12,0,12,398,116,106,84,292,100
1500000US530330317062,530330317062,"Block Group 2, Census Tract 317.06, King County, Washington",789,129,193,133,30,34,163,128,596,149,171,77,425,136
1500000US530330317063,530330317063,"Block Group 3, Census Tract 317.06, King County, Washington",505,96,74,48,0,12,74,48,431,104,117,68,314,93
1500000US530330317064,530330317064,"Block Group 4, Census Tract 317.06, King County, Washington",657,96,63,60,22,36,41,46,594,113,29,37,565,114
1500000US530330318001,530330318001,"Block Group 1, Census Tract 318, King County, Washington",751,89,16,16,7,13,9,14,735,90,120,61,615,91
1500000US530330318002,530330318002,"Block Group 2, Census Tract 318, King County, Washington",513,77,15,19,15,19,0,12,498,80,103,50,395,89
1500000US530330318003,530330318003,"Block Group 3, Census Tract 318, King County, Washington",526,86,49,64,6,10,43,63,477,75,88,40,389,84
1500000US530330319031,530330319031,"Block Group 1, Census Tract 319.03, King County, Washington",583,87,0,12,0,12,0,12,583,87,200,102,383,99
1500000US530330319032,530330319032,"Block Group 2, Census Tract 319.03, King County, Washington",572,110,88,86,88,86,0,12,484,95,120,53,364,96
1500000US530330319033,530330319033,"Block Group 3, Census Tract 319.03, King County, Washington",409,76,27,34,18,30,9,17,382,79,56,43,326,89
1500000US530330319034,530330319034,"Block Group 4, Census Tract 319.03, King County, Washington",350,75,0,12,0,12,0,12,350,75,150,74,200,66
1500000US530330319035,530330319035,"Block Group 5, Census Tract 319.03, King County, Washington",377,95,73,68,34,55,39,50,304,96,50,46,254,86
1500000US530330319041,530330319041,"Block Group 1, Census Tract 319.04, King County, Washington",633,71,33,31,0,12,33,31,600,77,48,33,552,79
1500000US530330319042,530330319042,"Block Group 2, Census Tract 319.04, King County, Washington",284,59,31,41,0,12,31,41,253,59,19,26,234,60
1500000US530330319043,530330319043,"Block Group 3, Census Tract 319.04, King County, Washington",390,78,47,52,0,12,47,52,343,73,106,48,237,77
1500000US530330319061,530330319061,"Block Group 1, Census Tract 319.06, King County, Washington",537,90,31,36,31,36,0,12,506,95,80,50,426,103
1500000US530330319062,530330319062,"Block Group 2, Census Tract 319.06, King County, Washington",797,104,10,15,10,15,0,12,787,106,87,48,700,105
1500000US530330319071,530330319071,"Block Group 1, Census Tract 319.07, King County, Washington",366,94,0,12,0,12,0,12,366,94,84,67,282,66
1500000US530330319072,530330319072,"Block Group 2, Census Tract 319.07, King County, Washington",256,61,0,12,0,12,0,12,256,61,97,50,159,60
1500000US530330319073,530330319073,"Block Group 3, Census Tract 319.07, King County, Washington",1003,174,64,72,7,12,57,72,939,164,83,79,856,156
1500000US530330319074,530330319074,"Block Group 4, Census Tract 319.07, King County, Washington",777,138,32,38,32,38,0,12,745,141,46,46,699,150
1500000US530330319075,530330319075,"Block Group 5, Census Tract 319.07, King County, Washington",335,104,8,13,8,13,0,12,327,106,34,60,293,89
1500000US530330319081,530330319081,"Block Group 1, Census Tract 319.08, King County, Washington",749,100,82,68,13,20,69,66,667,94,110,48,557,105
1500000US530330319082,530330319082,"Block Group 2, Census Tract 319.08, King County, Washington",732,89,141,90,52,52,89,73,591,122,109,73,482,115
1500000US530330319083,530330319083,"Block Group 3, Census Tract 319.08, King County, Washington",458,104,69,41,50,35,19,21,389,101,111,67,278,79
1500000US530330319091,530330319091,"Block Group 1, Census Tract 319.09, King County, Washington",742,66,107,61,51,42,56,52,635,84,117,53,518,84
1500000US530330319092,530330319092,"Block Group 2, Census Tract 319.09, King County, Washington",426,66,0,12,0,12,0,12,426,66,71,39,355,70
1500000US530330320021,530330320021,"Block Group 1, Census Tract 320.02, King County, Washington",633,82,90,60,69,56,21,23,543,99,100,53,443,97
1500000US530330320022,530330320022,"Block Group 2, Census Tract 320.02, King County, Washington",575,83,19,20,10,16,9,13,556,85,150,86,406,91
1500000US530330320031,530330320031,"Block Group 1, Census Tract 320.03, King County, Washington",556,81,32,25,9,15,23,24,524,84,97,50,427,83
1500000US530330320032,530330320032,"Block Group 2, Census Tract 320.03, King County, Washington",466,92,13,17,13,17,0,12,453,94,95,51,358,93
1500000US530330320033,530330320033,"Block Group 3, Census Tract 320.03, King County, Washington",336,68,24,27,15,24,9,15,312,66,70,40,242,67
1500000US530330320034,530330320034,"Block Group 4, Census Tract 320.03, King County, Washington",529,110,35,40,0,12,35,40,494,115,100,53,394,111
1500000US530330320051,530330320051,"Block Group 1, Census Tract 320.05, King County, Washington",391,134,43,64,0,12,43,64,348,138,22,29,326,144
1500000US530330320052,530330320052,"Block Group 2, Census Tract 320.05, King County, Washington",279,101,36,42,19,30,17,28,243,105,33,29,210,108
1500000US530330320053,530330320053,"Block Group 3, Census Tract 320.05, King County, Washington",254,81,59,53,59,53,0,12,195,85,18,28,177,83
1500000US530330320054,530330320054,"Block Group 4, Census Tract 320.05, King County, Washington",450,89,66,59,11,20,55,56,384,101,55,53,329,100
1500000US530330320055,530330320055,"Block Group 5, Census Tract 320.05, King County, Washington",665,117,98,101,16,23,82,97,567,136,104,86,463,146
1500000US530330320056,530330320056,"Block Group 6, Census Tract 320.05, King County, Washington",258,77,9,16,0,12,9,16,249,78,67,58,182,62
1500000US530330320061,530330320061,"Block Group 1, Census Tract 320.06, King County, Washington",405,59,26,25,26,25,0,12,379,63,46,31,333,64
1500000US530330320062,530330320062,"Block Group 2, Census Tract 320.06, King County, Washington",800,108,24,23,0,12,24,23,776,108,144,49,632,119
1500000US530330320063,530330320063,"Block Group 3, Census Tract 320.06, King County, Washington",537,81,55,45,0,12,55,45,482,83,47,30,435,87
1500000US530330320071,530330320071,"Block Group 1, Census Tract 320.07, King County, Washington",471,86,0,12,0,12,0,12,471,86,108,48,363,91
1500000US530330320072,530330320072,"Block Group 2, Census Tract 320.07, King County, Washington",477,90,0,12,0,12,0,12,477,90,96,51,381,86
1500000US530330320073,530330320073,"Block Group 3, Census Tract 320.07, King County, Washington",432,86,61,46,18,22,43,41,371,96,124,74,247,84
1500000US530330320081,530330320081,"Block Group 1, Census Tract 320.08, King County, Washington",491,81,11,16,11,16,0,12,480,82,66,37,414,83
1500000US530330320082,530330320082,"Block Group 2, Census Tract 320.08, King County, Washington",525,93,53,49,43,47,10,15,472,98,81,52,391,94
1500000US530330320083,530330320083,"Block Group 3, Census Tract 320.08, King County, Washington",373,84,26,32,7,13,19,29,347,86,35,40,312,87
1500000US530330320101,530330320101,"Block Group 1, Census Tract 320.10, King County, Washington",583,114,57,59,0,12,57,59,526,107,185,79,341,81
1500000US530330320102,530330320102,"Block Group 2, Census Tract 320.10, King County, Washington",412,71,0,12,0,12,0,12,412,71,25,29,387,73
1500000US530330320103,530330320103,"Block Group 3, Census Tract 320.10, King County, Washington",443,91,25,40,0,12,25,40,418,94,44,40,374,94
1500000US530330320104,530330320104,"Block Group 4, Census Tract 320.10, King County, Washington",591,118,8,15,0,12,8,15,583,118,99,66,484,126
1500000US530330320111,530330320111,"Block Group 1, Census Tract 320.11, King County, Washington",812,72,26,29,0,12,26,29,786,75,125,56,661,87
1500000US530330320112,530330320112,"Block Group 2, Census Tract 320.11, King County, Washington",570,74,9,14,9,14,0,12,561,74,50,33,511,78
1500000US530330321021,530330321021,"Block Group 1, Census Tract 321.02, King County, Washington",506,67,11,16,11,16,0,12,495,66,61,36,434,74
1500000US530330321022,530330321022,"Block Group 2, Census Tract 321.02, King County, Washington",269,64,44,48,44,48,0,12,225,54,49,31,176,52
1500000US530330321023,530330321023,"Block Group 3, Census Tract 321.02, King County, Washington",510,68,0,12,0,12,0,12,510,68,116,57,394,74
1500000US530330321024,530330321024,"Block Group 4, Census Tract 321.02, King County, Washington",522,85,0,12,0,12,0,12,522,85,100,44,422,91
1500000US530330321031,530330321031,"Block Group 1, Census Tract 321.03, King County, Washington",337,96,26,28,15,24,11,17,311,92,42,39,269,92
1500000US530330321032,530330321032,"Block Group 2, Census Tract 321.03, King County, Washington",435,95,47,63,8,14,39,63,388,92,65,45,323,88
1500000US530330321033,530330321033,"Block Group 3, Census Tract 321.03, King County, Washington",659,119,69,66,55,62,14,22,590,122,87,70,503,126
1500000US530330321034,530330321034,"Block Group 4, Census Tract 321.03, King County, Washington",582,92,19,29,19,29,0,12,563,90,55,45,508,94
1500000US530330321041,530330321041,"Block Group 1, Census Tract 321.04, King County, Washington",834,119,15,26,15,26,0,12,819,115,164,66,655,106
1500000US530330321042,530330321042,"Block Group 2, Census Tract 321.04, King County, Washington",924,147,109,73,17,27,92,79,815,146,89,48,726,151
1500000US530330321043,530330321043,"Block Group 3, Census Tract 321.04, King County, Washington",751,123,141,104,85,66,56,87,610,133,14,22,596,133
1500000US530330322031,530330322031,"Block Group 1, Census Tract 322.03, King County, Washington",580,105,15,24,0,12,15,24,565,107,40,42,525,108
1500000US530330322032,530330322032,"Block Group 2, Census Tract 322.03, King County, Washington",467,115,0,12,0,12,0,12,467,115,70,55,397,123
1500000US530330322033,530330322033,"Block Group 3, Census Tract 322.03, King County, Washington",933,123,0,12,0,12,0,12,933,123,91,66,842,122
1500000US530330322034,530330322034,"Block Group 4, Census Tract 322.03, King County, Washington",440,101,0,12,0,12,0,12,440,101,95,81,345,93
1500000US530330322071,530330322071,"Block Group 1, Census Tract 322.07, King County, Washington",330,52,0,12,0,12,0,12,330,52,10,13,320,54
1500000US530330322072,530330322072,"Block Group 2, Census Tract 322.07, King County, Washington",330,63,0,12,0,12,0,12,330,63,61,34,269,62
1500000US530330322073,530330322073,"Block Group 3, Census Tract 322.07, King County, Washington",445,66,0,12,0,12,0,12,445,66,25,20,420,69
1500000US530330322081,530330322081,"Block Group 1, Census Tract 322.08, King County, Washington",659,125,16,25,0,12,16,25,643,126,171,105,472,102
1500000US530330322082,530330322082,"Block Group 2, Census Tract 322.08, King County, Washington",670,95,13,21,13,21,0,12,657,95,277,82,380,116
1500000US530330322083,530330322083,"Block Group 3, Census Tract 322.08, King County, Washington",1025,151,20,31,20,31,0,12,1005,155,206,91,799,146
1500000US530330322084,530330322084,"Block Group 4, Census Tract 322.08, King County, Washington",889,149,40,36,17,26,23,26,849,151,39,39,810,161
1500000US530330322085,530330322085,"Block Group 5, Census Tract 322.08, King County, Washington",781,103,0,12,0,12,0,12,781,103,169,84,612,111
1500000US530330322101,530330322101,"Block Group 1, Census Tract 322.10, King County, Washington",498,118,15,25,0,12,15,25,483,122,56,54,427,131
1500000US530330322102,530330322102,"Block Group 2, Census Tract 322.10, King County, Washington",1904,206,29,47,0,17,29,47,1875,200,148,143,1727,215
1500000US530330322103,530330322103,"Block Group 3, Census Tract 322.10, King County, Washington",1757,215,79,127,0,12,79,127,1678,208,201,129,1477,197
1500000US530330322111,530330322111,"Block Group 1, Census Tract 322.11, King County, Washington",643,71,0,12,0,12,0,12,643,71,73,59,570,71
1500000US530330322112,530330322112,"Block Group 2, Census Tract 322.11, King County, Washington",619,80,0,12,0,12,0,12,619,80,60,34,559,84
1500000US530330322113,530330322113,"Block Group 3, Census Tract 322.11, King County, Washington",482,68,12,20,0,12,12,20,470,67,14,15,456,71
1500000US530330322121,530330322121,"Block Group 1, Census Tract 322.12, King County, Washington",861,118,0,12,0,12,0,12,861,118,55,56,806,123
1500000US530330322122,530330322122,"Block Group 2, Census Tract 322.12, King County, Washington",365,73,10,18,0,12,10,18,355,77,0,12,355,77
1500000US530330322123,530330322123,"Block Group 3, Census Tract 322.12, King County, Washington",465,81,0,12,0,12,0,12,465,81,0,12,465,81
1500000US530330322124,530330322124,"Block Group 4, Census Tract 322.12, King County, Washington",1265,140,145,139,52,56,93,127,1120,166,103,62,1017,170
1500000US530330322131,530330322131,"Block Group 1, Census Tract 322.13, King County, Washington",376,82,0,12,0,12,0,12,376,82,54,51,322,81
1500000US530330322132,530330322132,"Block Group 2, Census Tract 322.13, King County, Washington",300,59,0,12,0,12,0,12,300,59,39,36,261,71
1500000US530330322133,530330322133,"Block Group 3, Census Tract 322.13, King County, Washington",764,100,32,48,0,12,32,48,732,102,93,44,639,104
1500000US530330322141,530330322141,"Block Group 1, Census Tract 322.14, King County, Washington",522,89,15,27,15,27,0,12,507,89,41,34,466,91
1500000US530330322142,530330322142,"Block Group 2, Census Tract 322.14, King County, Washington",856,84,0,12,0,12,0,12,856,84,136,69,720,92
1500000US530330322143,530330322143,"Block Group 3, Census Tract 322.14, King County, Washington",609,83,0,12,0,12,0,12,609,83,107,80,502,96
1500000US530330322151,530330322151,"Block Group 1, Census Tract 322.15, King County, Washington",549,82,0,12,0,12,0,12,549,82,17,20,532,87
1500000US530330322152,530330322152,"Block Group 2, Census Tract 322.15, King County, Washington",845,84,0,12,0,12,0,12,845,84,54,37,791,92
1500000US530330323071,530330323071,"Block Group 1, Census Tract 323.07, King County, Washington",598,91,18,27,0,12,18,27,580,97,75,79,505,102
1500000US530330323072,530330323072,"Block Group 2, Census Tract 323.07, King County, Washington",318,72,0,12,0,12,0,12,318,72,14,22,304,77
1500000US530330323073,530330323073,"Block Group 3, Census Tract 323.07, King County, Washington",534,84,0,12,0,12,0,12,534,84,53,39,481,93
1500000US530330323074,530330323074,"Block Group 4, Census Tract 323.07, King County, Washington",483,97,0,12,0,12,0,12,483,97,33,32,450,97
1500000US530330323075,530330323075,"Block Group 5, Census Tract 323.07, King County, Washington",397,75,13,21,0,12,13,21,384,79,14,23,370,77
1500000US530330323091,530330323091,"Block Group 1, Census Tract 323.09, King County, Washington",780,172,0,12,0,12,0,12,780,172,123,76,657,161
1500000US530330323092,530330323092,"Block Group 2, Census Tract 323.09, King County, Washington",1530,209,74,48,74,48,0,12,1456,202,110,66,1346,211
1500000US530330323093,530330323093,"Block Group 3, Census Tract 323.09, King County, Washington",693,101,26,30,15,24,11,20,667,109,57,41,610,105
1500000US530330323111,530330323111,"Block Group 1, Census Tract 323.11, King County, Washington",379,72,0,12,0,12,0,12,379,72,61,51,318,74
1500000US530330323112,530330323112,"Block Group 2, Census Tract 323.11, King County, Washington",492,83,0,12,0,12,0,12,492,83,89,77,403,92
1500000US530330323113,530330323113,"Block Group 3, Census Tract 323.11, King County, Washington",290,59,0,12,0,12,0,12,290,59,64,53,226,62
1500000US530330323114,530330323114,"Block Group 4, Census Tract 323.11, King County, Washington",523,92,0,12,0,12,0,12,523,92,39,29,484,96
1500000US530330323115,530330323115,"Block Group 5, Census Tract 323.11, King County, Washington",302,107,0,12,0,12,0,12,302,107,15,22,287,110
1500000US530330323131,530330323131,"Block Group 1, Census Tract 323.13, King County, Washington",304,64,0,12,0,12,0,12,304,64,43,33,261,68
1500000US530330323132,530330323132,"Block Group 2, Census Tract 323.13, King County, Washington",572,87,27,39,27,39,0,12,545,91,118,52,427,88
1500000US530330323133,530330323133,"Block Group 3, Census Tract 323.13, King County, Washington",240,76,0,12,0,12,0,12,240,76,87,70,153,57
1500000US530330323134,530330323134,"Block Group 4, Census Tract 323.13, King County, Washington",1359,146,52,47,30,34,22,34,1307,155,105,61,1202,163
1500000US530330323151,530330323151,"Block Group 1, Census Tract 323.15, King County, Washington",819,92,21,24,0,12,21,24,798,97,119,52,679,109
1500000US530330323152,530330323152,"Block Group 2, Census Tract 323.15, King County, Washington",538,101,15,22,0,12,15,22,523,102,53,41,470,101
1500000US530330323153,530330323153,"Block Group 3, Census Tract 323.15, King County, Washington",604,82,68,53,0,12,68,53,536,77,66,33,470,79
1500000US530330323161,530330323161,"Block Group 1, Census Tract 323.16, King County, Washington",282,47,7,11,7,11,0,12,275,47,49,34,226,51
1500000US530330323162,530330323162,"Block Group 2, Census Tract 323.16, King County, Washington",512,47,0,12,0,12,0,12,512,47,47,34,465,54
1500000US530330323163,530330323163,"Block Group 3, Census Tract 323.16, King County, Washington",623,72,0,12,0,12,0,12,623,72,43,31,580,75
1500000US530330323164,530330323164,"Block Group 4, Census Tract 323.16, King County, Washington",435,61,0,12,0,12,0,12,435,61,25,21,410,64
1500000US530330323171,530330323171,"Block Group 1, Census Tract 323.17, King County, Washington",527,81,55,68,0,12,55,68,472,78,56,39,416,82
1500000US530330323172,530330323172,"Block Group 2, Census Tract 323.17, King County, Washington",468,80,0,12,0,12,0,12,468,80,0,12,468,80
1500000US530330323173,530330323173,"Block Group 3, Census Tract 323.17, King County, Washington",479,123,134,121,65,95,69,81,345,105,12,19,333,105
1500000US530330323174,530330323174,"Block Group 4, Census Tract 323.17, King County, Washington",309,68,0,12,0,12,0,12,309,68,88,54,221,61
1500000US530330323175,530330323175,"Block Group 5, Census Tract 323.17, King County, Washington",391,69,12,20,0,12,12,20,379,72,44,43,335,73
1500000US530330323181,530330323181,"Block Group 1, Census Tract 323.18, King County, Washington",706,70,0,12,0,12,0,12,706,70,67,41,639,77
1500000US530330323182,530330323182,"Block Group 2, Census Tract 323.18, King County, Washington",398,65,0,12,0,12,0,12,398,65,39,31,359,74
1500000US530330323183,530330323183,"Block Group 3, Census Tract 323.18, King County, Washington",294,46,0,12,0,12,0,12,294,46,17,18,277,51
1500000US530330323184,530330323184,"Block Group 4, Census Tract 323.18, King County, Washington",490,94,0,12,0,12,0,12,490,94,45,31,445,96
1500000US530330323191,530330323191,"Block Group 1, Census Tract 323.19, King County, Washington",218,76,12,19,12,19,0,12,206,78,27,37,179,71
1500000US530330323192,530330323192,"Block Group 2, Census Tract 323.19, King County, Washington",692,132,0,12,0,12,0,12,692,132,117,75,575,129
1500000US530330323193,530330323193,"Block Group 3, Census Tract 323.19, King County, Washington",906,184,138,106,0,12,138,106,768,184,113,57,655,187
1500000US530330323194,530330323194,"Block Group 4, Census Tract 323.19, King County, Washington",578,135,36,40,36,40,0,12,542,137,78,45,464,139
1500000US530330323201,530330323201,"Block Group 1, Census Tract 323.20, King County, Washington",407,61,12,19,12,19,0,12,395,62,74,36,321,64
1500000US530330323202,530330323202,"Block Group 2, Census Tract 323.20, King County, Washington",522,85,8,12,0,12,8,12,514,87,96,68,418,77
1500000US530330323203,530330323203,"Block Group 3, Census Tract 323.20, King County, Washington",539,77,0,12,0,12,0,12,539,77,22,19,517,80
1500000US530330323211,530330323211,"Block Group 1, Census Tract 323.21, King County, Washington",278,69,0,12,0,12,0,12,278,69,37,31,241,70
1500000US530330323212,530330323212,"Block Group 2, Census Tract 323.21, King County, Washington",411,69,24,34,24,34,0,12,387,72,39,31,348,72
1500000US530330323213,530330323213,"Block Group 3, Census Tract 323.21, King County, Washington",640,93,0,12,0,12,0,12,640,93,44,32,596,95
1500000US530330323214,530330323214,"Block Group 4, Census Tract 323.21, King County, Washington",381,65,0,12,0,12,0,12,381,65,0,12,381,65
1500000US530330323221,530330323221,"Block Group 1, Census Tract 323.22, King County, Washington",412,49,10,16,10,16,0,12,402,48,42,32,360,51
1500000US530330323222,530330323222,"Block Group 2, Census Tract 323.22, King County, Washington",239,41,0,12,0,12,0,12,239,41,9,14,230,41
1500000US530330323223,530330323223,"Block Group 3, Census Tract 323.22, King County, Washington",501,69,20,25,0,12,20,25,481,75,29,28,452,73
1500000US530330323231,530330323231,"Block Group 1, Census Tract 323.23, King County, Washington",499,105,0,12,0,12,0,12,499,105,68,60,431,107
1500000US530330323232,530330323232,"Block Group 2, Census Tract 323.23, King County, Washington",638,92,7,12,7,12,0,12,631,94,209,76,422,110
1500000US530330323233,530330323233,"Block Group 3, Census Tract 323.23, King County, Washington",565,102,0,12,0,12,0,12,565,102,69,50,496,107
1500000US530330323234,530330323234,"Block Group 4, Census Tract 323.23, King County, Washington",508,84,0,12,0,12,0,12,508,84,70,49,438,100
1500000US530330323241,530330323241,"Block Group 1, Census Tract 323.24, King County, Washington",288,61,13,22,13,22,0,12,275,59,48,44,227,68
1500000US530330323242,530330323242,"Block Group 2, Census Tract 323.24, King County, Washington",494,100,95,101,0,12,95,101,399,88,96,64,303,95
1500000US530330323243,530330323243,"Block Group 3, Census Tract 323.24, King County, Washington",939,128,119,69,79,75,40,40,820,124,44,42,776,127
1500000US530330323244,530330323244,"Block Group 4, Census Tract 323.24, King County, Washington",514,85,10,18,0,12,10,18,504,85,80,54,424,93
1500000US530330323251,530330323251,"Block Group 1, Census Tract 323.25, King County, Washington",107,39,0,12,0,12,0,12,107,39,0,12,107,39
1500000US530330323252,530330323252,"Block Group 2, Census Tract 323.25, King County, Washington",893,159,109,87,36,40,73,93,784,156,38,37,746,157
1500000US530330323253,530330323253,"Block Group 3, Census Tract 323.25, King County, Washington",1390,172,15,26,15,26,0,12,1375,168,124,78,1251,190
1500000US530330323261,530330323261,"Block Group 1, Census Tract 323.26, King County, Washington",439,71,0,12,0,12,0,12,439,71,40,29,399,79
1500000US530330323262,530330323262,"Block Group 2, Census Tract 323.26, King County, Washington",620,88,38,43,21,34,17,28,582,95,138,54,444,91
1500000US530330323263,530330323263,"Block Group 3, Census Tract 323.26, King County, Washington",333,82,14,23,0,12,14,23,319,84,27,36,292,79
1500000US530330323271,530330323271,"Block Group 1, Census Tract 323.27, King County, Washington",1673,119,21,19,21,19,0,12,1652,119,389,102,1263,130
1500000US530330323272,530330323272,"Block Group 2, Census Tract 323.27, King County, Washington",204,58,0,12,0,12,0,12,204,58,19,14,185,59
1500000US530330323281,530330323281,"Block Group 1, Census Tract 323.28, King County, Washington",387,73,0,12,0,12,0,12,387,73,88,56,299,66
1500000US530330323282,530330323282,"Block Group 2, Census Tract 323.28, King County, Washington",389,68,9,15,0,12,9,15,380,72,90,63,290,69
1500000US530330323283,530330323283,"Block Group 3, Census Tract 323.28, King County, Washington",369,68,0,12,0,12,0,12,369,68,21,23,348,67
1500000US530330323291,530330323291,"Block Group 1, Census Tract 323.29, King County, Washington",1179,118,17,26,0,12,17,26,1162,119,153,94,1009,146
1500000US530330323292,530330323292,"Block Group 2, Census Tract 323.29, King County, Washington",1705,149,55,50,0,12,55,50,1650,158,225,91,1425,163
1500000US530330324011,530330324011,"Block Group 1, Census Tract 324.01, King County, Washington",530,124,0,12,0,12,0,12,530,124,65,46,465,128
1500000US530330324012,530330324012,"Block Group 2, Census Tract 324.01, King County, Washington",635,119,17,27,17,27,0,12,618,119,84,62,534,126
1500000US530330324013,530330324013,"Block Group 3, Census Tract 324.01, King County, Washington",436,134,13,21,13,21,0,12,423,135,12,20,411,140
1500000US530330324014,530330324014,"Block Group 4, Census Tract 324.01, King County, Washington",468,117,0,12,0,12,0,12,468,117,128,98,340,125
1500000US530330324021,530330324021,"Block Group 1, Census Tract 324.02, King County, Washington",767,133,11,18,0,12,11,18,756,133,42,56,714,126
1500000US530330324022,530330324022,"Block Group 2, Census Tract 324.02, King County, Washington",659,106,11,17,11,17,0,12,648,109,75,68,573,109
1500000US530330324023,530330324023,"Block Group 3, Census Tract 324.02, King County, Washington",495,103,0,12,0,12,0,12,495,103,103,73,392,103
1500000US530330324024,530330324024,"Block Group 4, Census Tract 324.02, King County, Washington",278,111,73,78,0,12,73,78,205,85,45,41,160,87
1500000US530330325001,530330325001,"Block Group 1, Census Tract 325, King County, Washington",417,69,7,12,0,12,7,12,410,66,90,42,320,68
1500000US530330325002,530330325002,"Block Group 2, Census Tract 325, King County, Washington",607,77,10,15,10,15,0,12,597,79,97,53,500,80
1500000US530330325003,530330325003,"Block Group 3, Census Tract 325, King County, Washington",358,66,44,31,31,26,13,17,314,55,99,43,215,57
1500000US530330325004,530330325004,"Block Group 4, Census Tract 325, King County, Washington",564,80,23,20,4,6,19,19,541,79,79,34,462,88
1500000US530330326011,530330326011,"Block Group 1, Census Tract 326.01, King County, Washington",689,103,33,28,20,23,13,17,656,106,102,57,554,117
1500000US530330326012,530330326012,"Block Group 2, Census Tract 326.01, King County, Washington",402,79,27,42,0,12,27,42,375,74,86,41,289,77
1500000US530330326021,530330326021,"Block Group 1, Census Tract 326.02, King County, Washington",890,151,34,38,20,32,14,22,856,152,125,76,731,154
1500000US530330326022,530330326022,"Block Group 2, Census Tract 326.02, King County, Washington",383,116,40,65,0,12,40,65,343,100,48,51,295,111
1500000US530330326023,530330326023,"Block Group 3, Census Tract 326.02, King County, Washington",1420,155,116,103,38,60,78,89,1304,154,171,90,1133,155
1500000US530330326024,530330326024,"Block Group 4, Census Tract 326.02, King County, Washington",1200,160,50,79,0,12,50,79,1150,173,105,87,1045,176
1500000US530330327021,530330327021,"Block Group 1, Census Tract 327.02, King County, Washington",631,100,13,20,0,12,13,20,618,100,44,43,574,106
1500000US530330327022,530330327022,"Block Group 2, Census Tract 327.02, King County, Washington",429,67,0,12,0,12,0,12,429,67,39,30,390,77
1500000US530330327023,530330327023,"Block Group 3, Census Tract 327.02, King County, Washington",437,119,13,20,0,12,13,20,424,120,59,38,365,119
1500000US530330327024,530330327024,"Block Group 4, Census Tract 327.02, King County, Washington",369,119,18,30,0,12,18,30,351,125,32,35,319,123
1500000US530330327025,530330327025,"Block Group 5, Census Tract 327.02, King County, Washington",442,107,0,12,0,12,0,12,442,107,70,49,372,116
1500000US530330327026,530330327026,"Block Group 6, Census Tract 327.02, King County, Washington",293,73,11,17,11,17,0,12,282,75,71,50,211,70
1500000US530330327031,530330327031,"Block Group 1, Census Tract 327.03, King County, Washington",422,65,18,21,18,21,0,12,404,61,75,41,329,65
1500000US530330327032,530330327032,"Block Group 2, Census Tract 327.03, King County, Washington",351,78,53,39,17,15,36,40,298,73,35,26,263,77
1500000US530330327041,530330327041,"Block Group 1, Census Tract 327.04, King County, Washington",557,106,77,49,60,40,17,26,480,97,168,84,312,94
1500000US530330327042,530330327042,"Block Group 2, Census Tract 327.04, King County, Washington",545,122,52,76,0,12,52,76,493,112,92,57,401,122
1500000US530330327043,530330327043,"Block Group 3, Census Tract 327.04, King County, Washington",577,119,46,45,37,42,9,15,531,128,106,67,425,122
1500000US530330327044,530330327044,"Block Group 4, Census Tract 327.04, King County, Washington",709,148,225,125,85,93,140,100,484,152,168,104,316,126
1500000US530330328001,530330328001,"Block Group 1, Census Tract 328, King County, Washington",221,44,8,13,8,13,0,12,213,45,28,21,185,45
1500000US530330328002,530330328002,"Block Group 2, Census Tract 328, King County, Washington",563,67,0,12,0,12,0,12,563,67,64,30,499,80
1500000US530330328003,530330328003,"Block Group 3, Census Tract 328, King County, Washington",238,56,37,25,26,21,11,13,201,55,68,36,133,49
1500000US530339901000,530339901000,"Block Group 0, Census Tract 9901, King County, Washington",0,12,0,12,0,12,0,12,0,12,0,12,0,12
